,Date,Open,High,Low,Close,a1,a2,a3,a4,pl,,,
2000,30/10/2007,5821,5823,5795,5804,-67,183,-164,-48,-17,1,,
2001,31/10/2007,5804,5848,5794,5848,292,-132,-61,99,44,0,1,
2002,01/11/2007,5852,5855,5705,5731,-212,-319,-143,-674,-121,1,0,
2003,02/11/2007,5685,5726,5669,5720,-79,-45,-26,-150,35,0,0,
2004,05/11/2007,5677,5698,5660,5685,132,-62,-77,-7,8,0,0,
2005,06/11/2007,5702,5729,5684,5709,-281,58,-301,-524,7,0,0,
2006,07/11/2007,5738,5760,5646,5683,21,-7,26,40,-55,0,0,
2007,08/11/2007,5602,5675,5590,5632,89,-137,-301,-349,30,0,0,
2008,09/11/2007,5641,5661,5494,5524,226,-8,-61,157,-117,0,0,
2009,12/11/2007,5489,5540,5484,5536,-209,-307,-142,-658,47,0,0,
2010,13/11/2007,5509,5554,5486,5539,-16,175,221,380,30,0,1,
2011,14/11/2007,5626,5639,5591,5614,28,52,95,175,-12,0,0,
2012,15/11/2007,5598,5611,5526,5561,-106,-240,42,-304,-37,1,0,2
2013,16/11/2007,5519,5552,5497,5524,-185,80,53,-52,5,0,0,2
2014,19/11/2007,5520,5565,5429,5433,-218,30,-184,-372,-87,1,0,2
2015,20/11/2007,5460,5517,5413,5507,316,-208,86,194,47,0,1,3
2016,21/11/2007,5428,5443,5359,5381,36,71,27,134,-47,0,0,4
2017,22/11/2007,5403,5433,5364,5416,-60,-176,-57,-293,13,0,0,4
2018,23/11/2007,5406,5530,5406,5521,56,-76,88,68,115,0,1,4
2019,26/11/2007,5558,5568,5450,5458,-9,-110,-174,-293,-100,1,0,5
2020,27/11/2007,5422,5467,5384,5434,-7,9,-24,-22,12,0,0,6
2021,28/11/2007,5462,5578,5407,5561,315,517,-18,814,99,0,1,5
2022,29/11/2007,5597,5615,5550,5598,500,111,93,704,1,0,1,6
2023,30/11/2007,5603,5686,5597,5671,117,-78,55,94,68,0,1,6
2024,03/12/2007,5654,5680,5620,5629,-69,-91,-25,-185,-25,1,0,7
2025,04/12/2007,5620,5622,5538,5547,113,96,131,340,-73,0,0,7
2026,05/12/2007,5586,5663,5577,5659,203,-114,147,236,73,0,1,6
2027,06/12/2007,5682,5725,5628,5674,57,-220,9,-154,-8,1,0,7
2028,07/12/2007,5700,5745,5700,5719,-455,-200,-59,-714,19,0,0,8
2029,10/12/2007,5684,5771,5681,5751,-131,-9,127,-13,67,0,0,7
2030,11/12/2007,5765,5768,5703,5725,-200,-90,-43,-333,-40,1,0,6
2031,12/12/2007,5650,5795,5625,5743,96,18,-127,-13,93,0,0,7
2032,13/12/2007,5677,5677,5582,5591,-139,-141,-127,-407,-86,1,0,6
2033,14/12/2007,5625,5632,5561,5605,5,-419,96,-318,-20,1,0,6
2034,17/12/2007,5533,5542,5500,5515,-13,-277,65,-225,-18,1,0,6
2035,18/12/2007,5499,5581,5499,5509,-385,-11,-67,-463,10,0,0,6
2036,19/12/2007,5517,5548,5466,5497,-84,35,-67,-116,-20,1,0,6
2037,20/12/2007,5521,5550,5494,5511,39,-15,-67,-43,-10,1,0,6
2038,21/12/2007,5577,5623,5563,5603,63,56,90,209,26,0,1,6
2039,24/12/2007,5620,5622,5603,5614,-87,-286,-150,-523,-6,1,0,7
2040,27/12/2007,5626,5656,5618,5627,-88,241,257,410,1,0,1,8
2041,28/12/2007,5595,5640,5594,5627,186,415,182,783,32,0,1,8
2042,31/12/2007,5621,5622,5601,5614,-106,-211,135,-182,-7,1,0,9
2043,02/01/2008,5610,5666,5530,5550,43,-78,-157,-192,-60,1,0,9
2044,03/01/2008,5538,5559,5516,5546,23,40,35,98,8,0,1,9
2045,04/01/2008,5544,5567,5418,5447,-79,-45,42,-82,-97,1,0,9
2046,07/01/2008,5432,5475,5429,5453,57,-14,-44,-1,21,0,0,10
2047,08/01/2008,5477,5534,5471,5496,-9,56,-9,38,19,0,1,9
2048,09/01/2008,5459,5463,5420,5435,61,-483,-55,-477,-24,1,0,9
2049,10/01/2008,5469,5472,5395,5400,237,-319,-16,-98,-69,1,0,9
2050,11/01/2008,5398,5411,5349,5371,-211,-323,-313,-847,-27,1,0,9
2051,14/01/2008,5346,5421,5343,5404,-75,-175,39,-211,58,0,0,9
2052,15/01/2008,5390,5394,5250,5251,-142,191,-45,4,-139,0,0,8
2053,16/01/2008,5216,5289,5178,5225,-62,-920,-62,-1044,9,0,0,7
2054,17/01/2008,5278,5278,5150,5157,-141,-748,-141,-1030,-121,1,0,6
2055,18/01/2008,5160,5232,5081,5092,-158,275,-68,49,-68,0,0,6
2056,21/01/2008,5006,5013,4727,4744,-143,-602,-262,-1007,-262,1,0,5
2057,22/01/2008,4545,4904,4505,4843,298,298,298,894,298,0,1,6
2058,23/01/2008,4950,4950,4591,4637,-199,-289,-332,-820,-313,1,0,6
2059,24/01/2008,4817,4917,4774,4915,98,350,98,546,98,0,1,6
2060,25/01/2008,5002,5002,4855,4878,-55,46,-43,-52,-124,1,0,6
2061,28/01/2008,4792,4854,4756,4848,33,-41,146,138,56,0,1,6
2062,29/01/2008,4893,4949,4868,4941,299,63,48,410,48,0,1,7
2063,30/01/2008,4912,4912,4841,4874,253,123,111,487,-38,0,0,8
2064,31/01/2008,4863,4908,4763,4870,100,24,-162,-38,7,0,0,8
2065,01/02/2008,4936,5009,4927,4978,-21,6,-42,-57,42,0,0,7
2066,04/02/2008,5027,5027,4955,4974,-323,-172,121,-374,-53,1,0,7
2067,05/02/2008,4970,4971,4767,4777,-243,-26,-152,-421,-193,1,0,7
2068,06/02/2008,4729,4823,4729,4816,17,87,297,401,87,0,1,7
2069,07/02/2008,4793,4798,4683,4724,-42,58,-119,-103,-69,1,0,7
2070,08/02/2008,4765,4789,4680,4710,-152,-292,117,-327,-55,1,0,7
2071,11/02/2008,4653,4735,4645,4683,56,30,13,99,30,0,1,7
2072,12/02/2008,4729,4847,4676,4841,470,119,221,810,112,0,1,7
2073,13/02/2008,4792,4887,4782,4855,82,-92,51,41,63,0,1,7
2074,14/02/2008,4924,4926,4836,4859,-77,-44,-170,-291,-65,1,0,8
2075,15/02/2008,4857,4878,4744,4772,-11,-25,-97,-133,-85,1,0,9
2076,19/02/2008,4845,4940,4806,4886,18,196,11,225,41,0,1,10
2077,20/02/2008,4828,4867,4779,4813,60,62,-108,14,-15,0,0,10
2078,21/02/2008,4854,4905,4834,4859,-287,226,47,-14,5,0,0,9
2079,22/02/2008,4819,4878,4787,4825,157,-167,146,136,6,0,1,8
2080,25/02/2008,4878,4926,4870,4919,164,-8,51,207,41,0,1,8
2081,26/02/2008,4956,4981,4917,4973,164,116,-73,207,17,0,1,8
2082,27/02/2008,4991,4993,4893,4969,-47,-49,-4,-100,-22,1,0,8
2083,28/02/2008,4939,4964,4856,4865,-224,-178,-94,-496,-74,1,0,8
2084,29/02/2008,4837,4873,4769,4791,117,-67,43,93,-46,0,0,8
2085,03/03/2008,4723,4764,4698,4743,108,61,47,216,20,0,1,7
2086,04/03/2008,4749,4783,4655,4676,-252,56,-47,-243,-73,1,0,7
2087,05/03/2008,4723,4768,4689,4756,147,228,95,470,33,0,1,7
2088,06/03/2008,4767,4767,4664,4678,-58,85,104,131,-89,0,0,8
2089,07/03/2008,4631,4662,4577,4619,37,-56,-51,-70,-12,1,0,8
2090,10/03/2008,4602,4626,4535,4567,-155,-823,-66,-1044,-35,1,0,8
2091,11/03/2008,4590,4683,4567,4628,-124,63,-100,-161,38,0,0,8
2092,12/03/2008,4717,4742,4679,4697,-29,18,-155,-166,-20,1,0,7
2093,13/03/2008,4611,4642,4547,4630,77,-296,133,-86,19,0,0,7
2094,14/03/2008,4632,4708,4545,4592,-112,89,-81,-104,-40,1,0,6
2095,17/03/2008,4449,4506,4417,4431,-186,-53,-561,-800,-18,1,0,7
2096,18/03/2008,4503,4593,4482,4583,52,63,75,190,80,0,1,7
2097,19/03/2008,4635,4653,4533,4556,-74,56,-167,-185,-79,1,0,7
2098,20/03/2008,4511,4553,4481,4534,429,-67,6,368,23,0,1,7
2099,25/03/2008,4692,4700,4648,4692,175,89,160,424,0,0,0,8
2100,26/03/2008,4659,4694,4648,4677,28,89,32,149,18,0,1,7
2101,27/03/2008,4668,4751,4665,4720,-77,-34,23,-88,52,0,0,7
2102,28/03/2008,4723,4741,4680,4696,57,-88,140,109,-27,0,0,7
2103,31/03/2008,4649,4712,4622,4707,623,-333,-68,222,58,0,1,6
2104,01/04/2008,4690,4877,4681,4866,490,162,382,1034,176,0,1,7
2105,02/04/2008,4906,4923,4856,4912,70,-20,6,56,6,0,1,7
2106,03/04/2008,4926,4926,4854,4888,70,-38,-38,-6,-38,1,0,7
2107,04/04/2008,4914,4920,4849,4901,-2,-13,10,-5,-13,1,0,7
2108,07/04/2008,4936,4960,4927,4945,53,11,-30,34,9,0,1,7
2109,08/04/2008,4908,4914,4879,4913,-205,3,3,-199,5,0,0,7
2110,09/04/2008,4889,4925,4868,4875,-668,-385,-151,-1204,-14,1,0,7
2111,10/04/2008,4875,4881,4790,4859,110,-96,-20,-6,-16,1,0,7
2112,11/04/2008,4892,4918,4775,4798,20,-274,-148,-402,-94,1,0,8
2113,14/04/2008,4755,4794,4750,4766,65,-191,90,-36,11,0,0,9
2114,15/04/2008,4801,4821,4741,4781,-371,-17,-20,-408,-20,1,0,8
2115,16/04/2008,4820,4863,4789,4855,-58,277,34,253,35,0,1,8
2116,17/04/2008,4877,4901,4834,4862,-158,-92,-159,-409,-15,1,0,8
2117,18/04/2008,4882,4976,4878,4962,-152,-202,-3,-357,80,0,0,8
2118,21/04/2008,4954,4961,4885,4910,-365,-162,-145,-672,-44,1,0,7
2119,22/04/2008,4887,4930,4850,4873,-151,-92,-16,-259,-14,1,0,7
2120,23/04/2008,4888,4951,4851,4945,-177,234,419,476,57,0,1,8
2121,24/04/2008,4917,4943,4861,4930,140,-389,70,-179,13,0,0,8
2122,25/04/2008,4954,5013,4951,4978,-70,-30,-141,-241,24,0,0,7
2123,28/04/2008,4990,5031,4986,5013,-445,-312,-27,-784,23,0,0,6
2124,29/04/2008,4986,5013,4958,4977,-475,-153,56,-572,-9,1,0,6
2125,30/04/2008,4977,5006,4935,4997,-75,-12,-41,-128,20,0,0,6
2126,02/05/2008,5058,5099,5029,5070,108,-53,-118,-63,12,0,0,5
2127,05/05/2008,5063,5079,5048,5063,-556,-58,-56,-670,0,0,0,4
2128,06/05/2008,5053,5068,5011,5041,-778,-154,-139,-1071,-12,1,0,4
2129,07/05/2008,5059,5100,5042,5075,108,259,26,393,16,0,1,4
2130,08/05/2008,5029,5067,5025,5056,-587,-123,-7,-717,27,0,0,4
2131,09/05/2008,5001,5005,4925,4961,132,-112,87,107,-40,0,0,3
2132,12/05/2008,4975,5011,4955,4976,107,29,54,190,1,0,1,3
2133,13/05/2008,5002,5017,4951,4999,214,116,-91,239,-3,0,0,4
2134,14/05/2008,5037,5068,4992,5055,-29,-72,15,-86,18,0,0,4
2135,15/05/2008,5046,5060,5020,5058,112,-28,-61,23,12,0,1,3
2136,16/05/2008,5091,5121,5059,5078,30,-146,-136,-252,-13,1,0,4
2137,19/05/2008,5091,5142,5076,5142,-248,343,-97,-2,51,0,0,5
2138,20/05/2008,5091,5105,5041,5055,-388,94,-255,-549,-36,1,0,5
2139,21/05/2008,5065,5081,5003,5028,-337,232,2,-103,-37,1,0,5
2140,22/05/2008,4978,5048,4975,5029,112,-88,-16,8,51,0,1,5
2141,23/05/2008,5021,5021,4934,4934,98,-87,-127,-116,-87,1,0,6
2142,26/05/2008,4911,4951,4911,4938,75,18,-39,54,27,0,1,7
2143,27/05/2008,4957,4960,4894,4907,-158,233,-81,-6,-50,1,0,7
2144,28/05/2008,4924,5006,4914,4971,216,-121,-94,1,47,0,1,8
2145,29/05/2008,4988,5006,4952,4976,98,159,54,311,-12,0,0,9
2146,30/05/2008,4990,5029,4986,5014,119,164,15,298,24,0,1,8
2147,02/06/2008,5009,5012,4925,4935,-70,4,51,-15,-74,1,0,8
2148,03/06/2008,4914,4988,4914,4984,128,353,63,544,70,0,1,9
2149,04/06/2008,4966,4966,4867,4915,189,-127,-50,12,-51,0,0,9
2150,05/06/2008,4916,4944,4880,4907,-56,53,65,62,-9,0,0,8
2151,06/06/2008,4937,4969,4794,4795,-68,-128,-162,-358,-142,1,0,7
2152,09/06/2008,4779,4821,4775,4799,-139,62,-128,-205,20,0,0,7
2153,10/06/2008,4764,4793,4733,4761,17,193,52,262,-3,0,0,6
2154,11/06/2008,4777,4797,4660,4661,-65,-193,-120,-378,-116,1,0,5
2155,12/06/2008,4668,4695,4646,4672,4,102,4,110,4,0,1,5
2156,13/06/2008,4665,4689,4615,4682,17,51,71,139,17,0,1,6
2157,16/06/2008,4687,4691,4618,4658,-43,-51,0,-94,-29,1,0,6
2158,17/06/2008,4673,4723,4673,4686,111,-42,-1,68,13,0,1,6
2159,18/06/2008,4668,4677,4597,4619,-142,191,-45,4,-49,0,0,6
2160,19/06/2008,4591,4632,4591,4591,149,-189,-30,-70,0,0,0,6
2161,20/06/2008,4613,4617,4475,4509,466,-183,89,372,-104,0,0,6
2162,23/06/2008,4497,4539,4490,4511,-95,98,12,15,14,0,1,5
2163,24/06/2008,4514,4533,4426,4474,-92,237,37,182,-40,0,0,6
2164,25/06/2008,4490,4537,4490,4536,-16,-48,78,14,46,0,1,6
2165,26/06/2008,4491,4506,4426,4426,-43,-38,56,-25,-65,1,0,6
2166,27/06/2008,4408,4433,4348,4397,-57,-208,-296,-561,-11,1,0,6
2167,30/06/2008,4404,4440,4355,4435,-165,-176,10,-331,31,0,0,6
2168,01/07/2008,4411,4416,4307,4341,220,-65,243,398,-70,0,0,5
2169,02/07/2008,4350,4378,4296,4296,-178,-208,-3,-389,-54,1,0,4
2170,03/07/2008,4242,4358,4224,4344,470,68,328,866,102,0,1,5
2171,04/07/2008,4358,4359,4266,4266,55,-65,-181,-191,-92,1,0,6
2172,07/07/2008,4305,4351,4271,4343,33,47,-236,-156,38,0,0,7
2173,08/07/2008,4255,4292,4224,4276,299,159,35,493,21,0,1,6
2174,09/07/2008,4324,4343,4301,4340,58,122,-50,130,16,0,1,7
2175,10/07/2008,4262,4293,4210,4232,-81,97,-43,-27,-30,1,0,7
2176,11/07/2008,4250,4261,4101,4101,-286,-326,-196,-808,-149,1,0,7
2177,14/07/2008,4148,4189,4135,4143,-23,63,-203,-163,-5,1,0,7
2178,15/07/2008,4088,4110,4025,4061,-104,135,63,94,-27,0,0,8
2179,16/07/2008,4070,4116,4003,4112,-50,-615,-82,-747,42,0,0,8
2180,17/07/2008,4174,4261,4159,4226,222,146,29,397,52,0,1,7
2181,18/07/2008,4187,4299,4178,4299,82,-44,112,150,112,0,1,7
2182,21/07/2008,4310,4362,4262,4327,-208,307,-3,96,17,0,1,7
2183,22/07/2008,4287,4333,4259,4327,-236,116,55,-65,40,0,0,8
2184,23/07/2008,4390,4419,4367,4409,113,-34,73,152,19,0,1,7
2185,24/07/2008,4435,4441,4329,4348,-40,-93,-87,-220,-87,1,0,7
2186,25/07/2008,4303,4398,4299,4377,-213,40,134,-39,74,0,0,7
2187,28/07/2008,4368,4368,4317,4324,11,19,134,164,-44,0,0,6
2188,29/07/2008,4281,4346,4256,4320,-216,-20,-35,-271,39,0,0,5
2189,30/07/2008,4385,4424,4347,4401,-28,110,-142,-60,16,0,0,5
2190,31/07/2008,4416,4448,4365,4392,-9,-66,-42,-117,-24,1,0,5
2191,01/08/2008,4345,4379,4297,4314,-36,51,-207,-192,-31,1,0,5
2192,04/08/2008,4307,4332,4267,4281,97,-44,-97,-44,-26,1,0,5
2193,05/08/2008,4301,4391,4282,4386,-155,-12,86,-81,85,0,0,5
2194,06/08/2008,4424,4454,4396,4448,26,-83,71,14,24,0,1,5
2195,07/08/2008,4435,4514,4432,4457,-277,-10,-89,-376,22,0,0,5
2196,08/08/2008,4432,4496,4416,4492,-106,157,58,109,60,0,1,4
2197,11/08/2008,4500,4538,4486,4538,-132,-31,-128,-291,38,0,0,5
2198,12/08/2008,4521,4552,4494,4518,-197,61,61,-75,-3,1,0,5
2199,13/08/2008,4492,4500,4398,4403,-696,-320,-329,-1345,-89,1,0,6
2200,14/08/2008,4439,4467,4383,4421,534,-148,10,396,-18,0,0,7
2201,15/08/2008,4446,4496,4421,4454,-234,-92,25,-301,8,0,0,6
2202,18/08/2008,4436,4501,4405,4449,-16,-145,-58,-219,13,0,0,5
2203,19/08/2008,4403,4403,4330,4333,27,55,6,88,-70,0,0,4
2204,20/08/2008,4356,4378,4327,4366,263,10,115,388,10,0,1,4
2205,21/08/2008,4336,4342,4295,4305,21,-173,-199,-351,-31,1,0,4
2206,22/08/2008,4323,4405,4306,4400,115,115,87,317,77,0,1,5
2207,25/08/2008,4383,4392,4351,4356,5,83,-18,70,-27,0,0,5
2208,26/08/2008,4331,4384,4296,4369,128,-10,-140,-22,38,0,0,5
2209,27/08/2008,4371,4390,4310,4373,18,31,-80,-31,2,0,0,4
2210,28/08/2008,4370,4480,4340,4461,164,270,33,467,91,0,1,3
2211,29/08/2008,4474,4509,4456,4483,-22,-114,-20,-156,9,0,0,4
2212,01/09/2008,4456,4492,4437,4472,-143,-261,-37,-441,16,0,0,4
2213,02/09/2008,4465,4559,4444,4539,149,-425,-56,-332,74,0,0,4
2214,03/09/2008,4502,4512,4447,4447,-200,-36,-55,-291,-55,1,0,4
2215,04/09/2008,4444,4457,4302,4304,113,-126,-101,-114,-140,1,0,4
2216,05/09/2008,4272,4288,4182,4197,-75,-87,-75,-237,-75,1,0,4
2217,08/09/2008,4356,4409,4290,4340,-71,295,-71,153,-16,0,0,4
2218,09/09/2008,4335,4387,4275,4293,-24,-38,1,-61,-42,1,0,4
2219,10/09/2008,4297,4315,4239,4284,-292,156,-78,-214,-13,1,0,5
2220,11/09/2008,4275,4287,4193,4249,-223,-11,-78,-312,-26,1,0,6
2221,12/09/2008,4315,4333,4257,4333,229,20,72,321,18,0,1,6
2222,15/09/2008,4185,4233,4076,4169,-45,52,-41,-34,-16,1,0,7
2223,16/09/2008,4098,4158,4027,4087,-3,-76,6,-73,-11,1,0,8
2224,17/09/2008,4159,4160,3991,4000,-151,-848,-119,-1118,-159,1,0,9
2225,18/09/2008,3981,4078,3927,3958,-23,116,-23,70,-23,0,0,9
2226,19/09/2008,4226,4325,4090,4325,99,-399,99,-201,99,0,0,8
2227,22/09/2008,4331,4357,4224,4224,-86,-107,-120,-313,-107,1,0,7
2228,23/09/2008,4197,4206,4114,4140,131,-33,-51,47,-57,0,0,8
2229,24/09/2008,4161,4169,4097,4115,-74,9,353,288,-46,0,0,7
2230,25/09/2008,4113,4232,4111,4227,458,401,208,1067,114,0,1,6
2231,26/09/2008,4165,4202,4107,4163,-146,-396,49,-493,-2,1,0,6
2232,29/09/2008,4161,4161,3953,3953,-214,-372,-115,-701,-208,1,0,6
2233,30/09/2008,3851,4043,3845,4032,209,328,233,770,181,0,1,6
2234,01/10/2008,4071,4071,3998,4055,-44,85,-181,-140,-16,1,0,6
2235,02/10/2008,4063,4112,3963,3963,-182,-218,-38,-438,-100,1,0,6
2236,03/10/2008,3977,4111,3934,4081,44,143,12,199,104,0,1,7
2237,06/10/2008,3887,3911,3680,3712,-150,-10,-88,-248,-175,1,0,8
2238,07/10/2008,3828,3857,3689,3732,10,-11,10,9,-96,0,0,8
2239,08/10/2008,3561,3759,3427,3497,-64,-64,-109,-237,-64,1,0,8
2240,09/10/2008,3568,3612,3390,3443,-125,-125,-125,-375,-125,1,0,9
2241,10/10/2008,3165,3280,3048,3176,11,165,11,187,11,0,1,9
2242,13/10/2008,3380,3532,3290,3532,152,152,152,456,152,0,1,9
2243,14/10/2008,3681,3767,3556,3629,-52,51,-52,-53,-52,1,0,9
2244,15/10/2008,3616,3616,3347,3381,163,-84,2,81,-235,0,0,9
2245,16/10/2008,3215,3354,3116,3181,23,-34,-162,-173,-34,1,0,8
2246,17/10/2008,3349,3350,3179,3330,-19,-19,-332,-370,-19,1,0,8
2247,20/10/2008,3414,3449,3356,3449,-271,-27,17,-281,35,0,0,8
2248,21/10/2008,3537,3546,3436,3475,17,-135,-193,-311,-62,1,0,7
2249,22/10/2008,3380,3418,3292,3298,-261,9,-47,-299,-82,1,0,8
2250,23/10/2008,3311,3344,3182,3311,633,32,417,1082,0,0,0,8
2251,24/10/2008,3152,3194,2959,3194,-149,-153,22,-280,42,0,0,7
2252,27/10/2008,3035,3128,2976,3067,-136,32,-119,-223,32,0,0,6
2253,28/10/2008,3160,3176,2996,3115,-56,215,-109,50,-45,0,0,5
2254,29/10/2008,3297,3403,3269,3403,183,397,130,710,106,0,1,4
2255,30/10/2008,3489,3489,3328,3408,-167,-81,-131,-379,-81,1,0,5
2256,31/10/2008,3389,3487,3319,3487,-193,66,172,45,98,0,1,5
2257,03/11/2008,3513,3528,3460,3528,-69,83,83,97,15,0,1,5
2258,04/11/2008,3545,3691,3519,3691,125,126,146,397,146,0,1,6
2259,05/11/2008,3668,3675,3569,3618,-50,-50,-50,-150,-50,1,0,6
2260,06/11/2008,3504,3575,3378,3387,-34,-100,-100,-234,-117,1,0,6
2261,07/11/2008,3393,3510,3351,3469,-19,-38,202,145,76,0,1,7
2262,10/11/2008,3559,3612,3490,3506,-47,20,-267,-294,-53,1,0,8
2263,11/11/2008,3454,3460,3328,3336,-481,-365,-255,-1101,-118,1,0,9
2264,12/11/2008,3407,3410,3208,3234,-207,-292,-275,-774,-173,1,0,10
2265,13/11/2008,3196,3294,3184,3269,12,73,73,158,73,0,1,10
2266,14/11/2008,3371,3379,3270,3291,-360,-80,-80,-520,-80,1,0,10
2267,17/11/2008,3284,3310,3167,3182,-175,-93,-403,-671,-102,1,0,10
2268,18/11/2008,3194,3228,3104,3217,-48,23,3,-22,23,0,0,10
2269,19/11/2008,3216,3216,3085,3088,-60,-174,-162,-396,-128,1,0,9
2270,20/11/2008,3000,3037,2909,2980,-20,-20,3,-37,-20,1,0,9
2271,21/11/2008,3005,3041,2838,2881,-357,24,-124,-457,-124,1,0,9
2272,24/11/2008,2960,3172,2931,3172,212,138,212,562,212,0,1,9
2273,25/11/2008,3126,3275,3104,3210,175,53,220,448,84,0,1,9
2274,26/11/2008,3184,3213,3095,3170,-104,349,-336,-91,-14,1,0,9
2275,27/11/2008,3223,3255,3205,3250,-14,-176,97,-93,27,0,0,9
2276,28/11/2008,3239,3263,3177,3263,38,140,30,208,24,0,1,8
2277,01/12/2008,3261,3272,3072,3080,-232,-143,-238,-613,-181,1,0,8
2278,02/12/2008,3030,3160,3012,3153,315,53,157,525,123,0,1,8
2279,03/12/2008,3147,3184,3056,3167,-279,96,-70,-253,20,0,0,9
2280,04/12/2008,3160,3257,3109,3161,-25,88,-127,-64,1,0,0,8
2281,05/12/2008,3119,3128,2957,2988,-118,-164,-159,-441,-131,1,0,7
2282,08/12/2008,3190,3253,3154,3247,244,28,108,380,57,0,1,7
2283,09/12/2008,3211,3343,3199,3298,275,-16,-33,226,87,0,1,7
2284,10/12/2008,3310,3331,3262,3320,110,-68,-3,39,10,0,1,7
2285,11/12/2008,3309,3343,3263,3306,-200,-90,-43,-333,-3,1,0,7
2286,12/12/2008,3172,3242,3115,3214,-142,-140,-22,-304,42,0,0,8
2287,15/12/2008,3258,3269,3172,3186,-53,-324,-287,-664,-72,1,0,7
2288,16/12/2008,3186,3252,3177,3252,-29,157,187,315,66,0,1,7
2289,17/12/2008,3282,3305,3188,3242,-576,-154,-22,-752,-40,1,0,7
2290,18/12/2008,3247,3260,3197,3234,203,108,-287,24,-13,0,0,8
2291,19/12/2008,3190,3249,3147,3226,-76,87,-171,-160,36,0,0,8
2292,22/12/2008,3202,3209,3151,3151,-65,-59,48,-76,-51,1,0,7
2293,23/12/2008,3154,3188,3128,3128,-70,-65,-29,-164,-26,1,0,7
2294,24/12/2008,3111,3150,3095,3116,149,-34,-29,86,5,0,1,7
2295,29/12/2008,3139,3169,3105,3131,287,9,-29,267,-8,0,0,7
2296,30/12/2008,3160,3217,3151,3217,-148,45,72,-31,57,0,0,6
2297,31/12/2008,3242,3264,3218,3218,-367,-153,116,-404,-24,1,0,6
2298,02/01/2009,3241,3350,3220,3350,98,-223,61,-64,109,0,0,6
2299,05/01/2009,3381,3383,3323,3360,84,-28,-88,-32,-21,1,0,5
2300,06/01/2009,3373,3426,3339,3396,-7,-99,-77,-183,23,0,0,5
2301,07/01/2009,3379,3403,3317,3346,-200,-83,-33,-316,-33,1,0,5
2302,08/01/2009,3309,3346,3270,3324,-176,-122,-35,-333,15,0,0,6
2303,09/01/2009,3338,3368,3271,3300,-54,-112,-42,-208,-38,1,0,5
2304,12/01/2009,3288,3305,3236,3246,164,-114,38,88,-42,0,0,5
2305,13/01/2009,3232,3235,3154,3198,-278,84,-138,-332,-34,1,0,4
2306,14/01/2009,3217,3219,3018,3052,-292,-65,-165,-522,-165,1,0,5
2307,15/01/2009,3057,3072,2963,2996,12,-99,-61,-148,-61,1,0,6
2308,16/01/2009,3059,3108,3010,3017,-42,140,-42,56,-42,0,0,6
2309,19/01/2009,3070,3083,2950,2990,-80,-331,-80,-491,-80,1,0,6
2310,20/01/2009,2985,3032,2913,2925,-124,63,-100,-161,-60,1,0,6
2311,21/01/2009,2885,2948,2842,2906,21,102,21,144,21,0,1,7
2312,22/01/2009,2965,2981,2865,2870,-62,-713,-62,-837,-95,1,0,7
2313,23/01/2009,2869,2886,2770,2849,-141,-823,-141,-1105,-20,1,0,8
2314,26/01/2009,2839,2968,2835,2955,79,68,137,284,116,0,1,8
2315,27/01/2009,2970,2971,2908,2955,163,-83,-183,-103,-15,1,0,9
2316,28/01/2009,2998,3086,2990,3076,-9,-157,120,-46,78,0,0,9
2317,29/01/2009,3054,3064,2986,3010,-119,68,-238,-289,-44,1,0,8
2318,30/01/2009,2999,3028,2949,2974,43,-155,-281,-393,-25,1,0,8
2319,02/02/2009,2929,2941,2868,2930,-300,-248,97,-451,1,0,0,9
2320,03/02/2009,2951,2989,2899,2982,-69,15,-61,-115,31,0,0,8
2321,04/02/2009,3008,3098,2988,3069,-16,219,146,349,61,0,1,7
2322,05/02/2009,3011,3069,2977,3066,80,-149,186,117,55,0,1,7
2323,06/02/2009,3090,3147,3057,3123,455,176,256,887,33,0,1,7
2324,09/02/2009,3111,3146,3090,3135,57,-279,9,-213,24,0,0,7
2325,10/02/2009,3102,3124,3021,3021,20,-231,-118,-329,-81,1,0,6
2326,11/02/2009,2996,3034,2986,3028,-30,-102,60,-72,32,0,0,6
2327,12/02/2009,3010,3012,2932,2964,-4,25,-185,-164,-46,1,0,6
2328,13/02/2009,3012,3045,2986,2998,177,14,-362,-171,-14,1,0,6
2329,16/02/2009,2977,2994,2961,2962,-174,8,-72,-238,-15,1,0,6
2330,17/02/2009,2933,2936,2855,2875,14,-374,-259,-619,-58,1,0,7
2331,18/02/2009,2895,2898,2825,2874,-102,0,33,-69,-21,1,0,8
2332,19/02/2009,2893,2913,2861,2873,51,-188,104,-33,-20,1,0,8
2333,20/02/2009,2817,2830,2751,2751,61,-139,-12,-90,-66,1,0,8
2334,23/02/2009,2806,2811,2719,2728,-124,63,-100,-161,-78,1,0,8
2335,24/02/2009,2700,2734,2670,2708,-151,-615,-119,-885,8,0,0,9
2336,25/02/2009,2760,2760,2663,2697,-63,123,-63,-3,-63,1,0,8
2337,26/02/2009,2736,2770,2695,2745,58,-197,37,-102,9,0,0,9
2338,27/02/2009,2710,2715,2644,2702,21,-47,-184,-210,-8,1,0,8
2339,02/03/2009,2633,2639,2581,2581,-101,122,-7,14,-52,0,0,8
2340,03/03/2009,2591,2617,2552,2555,2,23,50,75,-36,0,0,7
2341,04/03/2009,2596,2676,2575,2676,-5,328,130,453,80,0,1,6
2342,05/03/2009,2658,2664,2570,2570,6,-100,9,-85,-88,1,0,6
2343,06/03/2009,2566,2598,2521,2534,-178,103,35,-40,-32,1,0,6
2344,09/03/2009,2553,2553,2465,2519,13,-87,83,9,-34,0,0,6
2345,10/03/2009,2519,2673,2510,2664,222,-327,-138,-243,145,0,0,5
2346,11/03/2009,2657,2735,2617,2674,-100,44,35,-21,17,0,0,5
2347,12/03/2009,2640,2697,2595,2694,-75,210,71,206,54,0,1,4
2348,13/03/2009,2744,2772,2695,2706,-77,113,22,58,-38,0,0,5
2349,16/03/2009,2762,2792,2747,2792,457,32,-15,474,30,0,1,4
2350,17/03/2009,2764,2782,2722,2767,3,-175,3,-169,3,0,0,5
2351,18/03/2009,2805,2814,2720,2760,34,-53,140,121,-45,0,0,5
2352,19/03/2009,2785,2833,2761,2777,371,-299,-38,34,-8,0,0,4
2353,20/03/2009,2749,2798,2725,2791,490,162,382,1034,42,0,1,3
2354,23/03/2009,2846,2874,2802,2870,9,143,-133,19,24,0,1,3
2355,24/03/2009,2915,2917,2841,2874,-418,-44,-44,-506,-41,1,0,4
2356,25/03/2009,2854,2918,2845,2893,-556,-231,-59,-846,39,0,0,5
2357,26/03/2009,2900,2906,2857,2892,-411,156,-52,-307,-8,1,0,5
2358,27/03/2009,2890,2902,2824,2841,-202,-109,-180,-491,-49,1,0,5
2359,30/03/2009,2788,2795,2719,2719,-73,-92,371,206,-69,0,0,6
2360,31/03/2009,2746,2808,2735,2807,-175,-74,59,-190,61,0,0,5
2361,01/04/2009,2793,2841,2741,2840,-191,-32,23,-200,47,0,0,5
2362,02/04/2009,2897,3001,2897,2992,342,87,-40,389,95,0,1,5
2363,03/04/2009,2973,3019,2948,2959,12,-76,-16,-80,-14,1,0,6
2364,06/04/2009,2993,3018,2905,2930,-659,-158,-175,-992,-63,1,0,6
2365,07/04/2009,2936,2950,2876,2902,103,-144,-172,-213,-34,1,0,6
2366,08/04/2009,2855,2937,2848,2921,164,171,345,680,66,0,1,6
2367,09/04/2009,2950,2991,2923,2974,-473,382,91,0,24,0,0,7
2368,14/04/2009,2994,3028,2961,3000,6,-398,-8,-400,6,0,0,6
2369,15/04/2009,2964,3003,2956,2986,-421,-311,11,-721,22,0,0,5
2370,16/04/2009,3007,3054,2978,3038,-192,-309,222,-279,31,0,0,5
2371,17/04/2009,3049,3102,3030,3092,-129,61,111,43,43,0,1,5
2372,20/04/2009,3081,3083,2959,2969,-208,-105,-112,-425,-112,1,0,6
2373,21/04/2009,2964,3003,2899,2974,-42,122,30,110,10,0,1,6
2374,22/04/2009,2975,3026,2935,3025,29,102,-168,-37,50,0,0,6
2375,23/04/2009,2996,3057,2984,3009,85,-54,78,109,13,0,1,5
2376,24/04/2009,3022,3103,3017,3103,-47,11,-40,-76,81,0,0,5
2377,27/04/2009,3043,3110,3040,3102,-56,157,58,159,59,0,1,4
2378,28/04/2009,3045,3085,3016,3051,96,-164,-111,-179,6,0,0,5
2379,29/04/2009,3073,3125,3063,3117,-82,282,285,485,44,0,1,5
2380,30/04/2009,3142,3194,3141,3160,-503,-314,-36,-853,18,0,0,6
2381,04/05/2009,3180,3241,3168,3238,-365,-149,60,-454,58,0,0,6
2382,05/05/2009,3244,3261,3210,3225,-92,140,-19,29,-19,0,0,5
2383,06/05/2009,3221,3309,3206,3284,211,63,123,397,63,0,1,4
2384,07/05/2009,3310,3356,3244,3252,-65,-85,-63,-213,-58,1,0,4
2385,08/05/2009,3282,3345,3279,3313,-625,-362,-255,-1242,31,0,0,5
2386,11/05/2009,3313,3313,3225,3249,-314,-35,-112,-461,-64,1,0,4
2387,12/05/2009,3209,3271,3209,3231,27,-53,-37,-63,22,0,0,5
2388,13/05/2009,3241,3255,3153,3153,-177,-402,-255,-834,-88,1,0,4
2389,14/05/2009,3136,3167,3118,3156,65,-242,102,-75,20,0,0,5
2390,15/05/2009,3179,3191,3135,3169,115,-155,102,62,-10,0,0,4
2391,18/05/2009,3135,3245,3115,3245,-76,-24,54,-46,110,0,0,4
2392,19/05/2009,3264,3295,3246,3275,-120,226,-270,-164,11,0,0,4
2393,20/05/2009,3262,3320,3259,3303,-33,343,-142,168,41,0,1,4
2394,21/05/2009,3261,3266,3209,3217,-44,-145,-121,-310,-44,1,0,4
2395,22/05/2009,3234,3261,3200,3228,99,-133,-79,-113,-6,1,0,4
2396,25/05/2009,3235,3249,3168,3236,59,-351,-24,-316,1,0,0,5
2397,26/05/2009,3216,3277,3171,3270,129,-3,47,173,54,0,1,4
2398,27/05/2009,3282,3302,3267,3295,66,234,-22,278,13,0,1,5
2399,28/05/2009,3250,3294,3232,3264,228,-154,131,205,14,0,1,5
2400,29/05/2009,3306,3318,3268,3278,237,-465,-122,-350,-28,1,0,6
2401,01/06/2009,3339,3384,3332,3379,11,-20,60,51,40,0,1,7
2402,02/06/2009,3347,3400,3342,3378,-535,45,-56,-546,31,0,0,8
2403,03/06/2009,3388,3388,3289,3310,-696,-363,-151,-1210,-78,1,0,8
2404,04/06/2009,3317,3352,3308,3312,54,-340,-194,-480,-5,1,0,8
2405,05/06/2009,3339,3390,3318,3339,9,161,-270,-100,0,0,0,8
2406,08/06/2009,3328,3331,3276,3290,-423,-56,-20,-499,-38,1,0,7
2407,09/06/2009,3315,3332,3284,3297,-201,-19,90,-130,-18,1,0,8
2408,10/06/2009,3339,3371,3303,3315,-46,-88,87,-47,-24,1,0,8
2409,11/06/2009,3301,3343,3294,3335,-197,-146,-208,-551,34,0,0,8
2410,12/06/2009,3331,3340,3311,3326,-139,-404,32,-511,-5,1,0,7
2411,15/06/2009,3309,3309,3213,3220,-87,-103,-195,-385,-89,1,0,7
2412,16/06/2009,3224,3248,3210,3214,267,-29,78,316,-10,0,0,7
2413,17/06/2009,3202,3211,3137,3161,-158,-160,108,-210,-41,1,0,7
2414,18/06/2009,3173,3207,3139,3194,34,-323,-28,-317,21,0,0,7
2415,19/06/2009,3196,3244,3184,3221,21,-39,-184,-202,25,0,0,6
2416,22/06/2009,3221,3224,3123,3123,-93,140,353,400,-98,0,0,6
2417,23/06/2009,3097,3144,3097,3117,17,-151,84,-50,20,0,0,5
2418,24/06/2009,3137,3197,3105,3185,145,-319,-9,-183,48,0,0,4
2419,25/06/2009,3179,3186,3110,3163,6,-21,9,-6,-16,1,0,3
2420,26/06/2009,3181,3204,3113,3130,-116,160,9,53,-51,0,0,4
2421,29/06/2009,3123,3205,3121,3194,363,45,331,739,71,0,1,3
2422,30/06/2009,3208,3208,3125,3140,126,106,-17,215,-68,0,0,3
2423,01/07/2009,3164,3234,3162,3217,-70,12,-199,-257,53,0,0,3
2424,02/07/2009,3201,3201,3116,3116,-218,-132,-33,-383,-85,1,0,2
2425,03/07/2009,3127,3133,3092,3120,290,-99,1,192,-7,0,0,3
2426,06/07/2009,3089,3103,3059,3082,113,30,39,182,-7,0,0,3
2427,07/07/2009,3098,3113,3045,3049,-126,8,47,-71,-49,1,0,3
2428,08/07/2009,3032,3049,3000,3010,-74,-140,38,-176,-22,1,0,4
2429,09/07/2009,3027,3059,3013,3026,27,-8,29,48,-1,0,0,5
2430,10/07/2009,3011,3023,2977,2983,-44,85,-181,-140,-28,1,0,4
2431,13/07/2009,2974,3052,2958,3052,299,-56,-61,182,78,0,1,5
2432,14/07/2009,3067,3094,3045,3082,32,-73,-30,-71,15,0,0,5
2433,15/07/2009,3105,3171,3102,3171,-16,89,57,130,66,0,1,5
2434,16/07/2009,3168,3228,3157,3200,28,111,-85,54,32,0,1,6
2435,17/07/2009,3222,3236,3207,3218,-46,14,15,-17,-4,1,0,6
2436,20/07/2009,3252,3279,3234,3271,-48,-111,15,-144,19,0,0,7
2437,21/07/2009,3277,3330,3266,3303,-175,7,26,-142,26,0,0,7
2438,22/07/2009,3309,3309,3268,3305,-146,-91,-4,-241,-4,1,0,6
2439,23/07/2009,3316,3380,3281,3374,-164,-29,58,-135,58,0,0,6
2440,24/07/2009,3358,3408,3347,3366,-163,5,8,-150,8,0,0,6
2441,27/07/2009,3405,3406,3350,3372,236,69,-233,72,-33,0,0,5
2442,28/07/2009,3375,3401,3327,3331,-167,-89,-112,-368,-44,1,0,4
2443,29/07/2009,3322,3395,3322,3366,-1,51,121,171,44,0,1,5
2444,30/07/2009,3397,3456,3373,3435,-192,32,222,62,38,0,1,5
2445,31/07/2009,3424,3447,3408,3426,-411,-295,-32,-738,2,0,0,5
2446,03/08/2009,3427,3506,3418,3478,45,-141,-74,-170,51,0,0,4
2447,04/08/2009,3481,3482,3441,3476,-475,-2,-100,-577,-5,1,0,4
2448,05/08/2009,3476,3508,3444,3459,-629,160,-15,-484,-17,1,0,5
2449,06/08/2009,3483,3508,3458,3478,60,-173,-29,-142,-5,1,0,5
2450,07/08/2009,3468,3539,3437,3521,-551,175,-18,-394,53,0,0,6
2451,10/08/2009,3505,3510,3483,3505,-106,-377,-55,-538,0,0,0,6
2452,11/08/2009,3512,3528,3445,3456,-300,-211,-67,-578,-56,1,0,6
2453,12/08/2009,3456,3512,3436,3507,25,-101,44,-32,51,0,0,6
2454,13/08/2009,3511,3558,3504,3524,217,455,171,843,13,0,1,5
2455,14/08/2009,3535,3554,3480,3495,-396,382,-58,-72,-40,1,0,5
2456,17/08/2009,3472,3474,3397,3420,-515,-351,-97,-963,-52,1,0,6
2457,18/08/2009,3436,3451,3420,3451,23,-88,15,-50,15,0,0,7
2458,19/08/2009,3425,3468,3405,3450,-56,90,66,100,25,0,1,6
2459,20/08/2009,3489,3517,3477,3505,50,90,-10,130,16,0,1,6
2460,21/08/2009,3494,3623,3490,3616,166,269,162,597,122,0,1,6
2461,24/08/2009,3631,3661,3621,3652,-125,-58,48,-135,21,0,0,7
2462,25/08/2009,3619,3689,3615,3681,-164,-36,-36,-236,62,0,0,7
2463,26/08/2009,3669,3694,3658,3668,30,153,-6,177,-1,0,0,6
2464,27/08/2009,3668,3686,3634,3649,231,-69,-5,157,-19,0,0,6
2465,28/08/2009,3681,3724,3668,3693,87,36,-46,77,12,0,1,5
2466,31/08/2009,3668,3683,3647,3654,-125,-102,-43,-270,-14,1,0,5
2467,01/09/2009,3677,3686,3583,3583,-151,-445,221,-375,-94,1,0,5
2468,02/09/2009,3579,3581,3535,3573,105,31,-121,15,-6,0,0,6
2469,03/09/2009,3587,3594,3543,3554,242,24,-193,73,-33,0,0,5
2470,04/09/2009,3567,3603,3567,3599,110,61,-14,157,32,0,1,4
2471,07/09/2009,3626,3660,3622,3653,-167,-110,-121,-398,27,0,0,4
2472,08/09/2009,3663,3677,3642,3661,1,-318,195,-122,-2,1,0,4
2473,09/09/2009,3646,3708,3644,3708,162,-110,153,205,62,0,1,5
2474,10/09/2009,3726,3732,3679,3706,-337,-53,-83,-473,-20,1,0,6
2475,11/09/2009,3723,3751,3723,3735,65,-25,90,130,12,0,1,7
2476,14/09/2009,3695,3733,3674,3731,-445,-202,-290,-937,36,0,0,7
2477,15/09/2009,3743,3766,3724,3752,-451,-433,-207,-1091,9,0,0,6
2478,16/09/2009,3772,3821,3767,3814,-64,-222,-185,-471,42,0,0,5
2479,17/09/2009,3844,3844,3810,3835,-125,-36,-17,-178,-9,1,0,5
2480,18/09/2009,3817,3854,3813,3828,-194,-49,24,-219,11,0,0,6
2481,21/09/2009,3827,3833,3788,3812,-771,61,-149,-859,-15,1,0,5
2482,22/09/2009,3827,3857,3815,3824,122,-68,-131,-77,-3,1,0,6
2483,23/09/2009,3823,3849,3807,3822,-51,38,-92,-105,-1,1,0,6
2484,24/09/2009,3809,3850,3752,3758,-437,-166,79,-524,-51,1,0,6
2485,25/09/2009,3761,3769,3732,3739,-158,58,63,-37,-22,1,0,6
2486,28/09/2009,3728,3825,3703,3825,-36,8,51,23,97,0,1,6
2487,29/09/2009,3831,3845,3799,3814,50,348,196,594,-17,0,0,7
2488,30/09/2009,3825,3842,3763,3795,-176,-226,-10,-412,-30,1,0,7
2489,01/10/2009,3802,3821,3720,3721,-41,-87,-55,-183,-81,1,0,8
2490,02/10/2009,3695,3699,3627,3650,-51,53,-81,-79,-45,1,0,8
2491,05/10/2009,3652,3677,3629,3675,-142,57,-75,-160,23,0,0,9
2492,06/10/2009,3691,3770,3679,3770,-17,-40,450,393,79,0,1,8
2493,07/10/2009,3765,3792,3749,3756,-72,-46,-188,-306,-9,1,0,8
2494,08/10/2009,3815,3818,3779,3807,175,137,-104,208,-8,0,0,8
2495,09/10/2009,3788,3823,3778,3800,-68,-209,28,-249,12,0,0,7
2496,12/10/2009,3813,3859,3806,3846,97,107,-40,164,33,0,1,6
2497,13/10/2009,3837,3847,3791,3801,-161,-308,-54,-523,-36,1,0,6
2498,14/10/2009,3847,3885,3844,3883,128,204,-197,135,36,0,1,7
2499,15/10/2009,3886,3898,3863,3884,-153,41,-62,-174,-2,1,0,7
2500,16/10/2009,3891,3907,3818,3828,-393,-147,57,-483,-63,1,0,7
2501,19/10/2009,3843,3892,3843,3892,189,38,257,484,49,0,1,7
2502,20/10/2009,3906,3914,3863,3871,-513,-66,-114,-693,-35,1,0,8
2503,21/10/2009,3881,3888,3806,3873,144,239,-198,185,-8,0,0,8
2504,22/10/2009,3823,3831,3792,3821,141,-106,-260,-225,-2,1,0,7
2505,23/10/2009,3856,3878,3807,3808,-95,-92,-87,-274,-48,1,0,8
2506,26/10/2009,3824,3838,3733,3744,-278,32,-158,-404,-80,1,0,9
2507,27/10/2009,3751,3772,3725,3744,-158,72,77,-9,-7,1,0,9
2508,28/10/2009,3732,3734,3661,3664,-207,-29,-34,-270,-68,1,0,9
2509,29/10/2009,3655,3722,3641,3714,9,59,33,101,59,0,1,9
2510,30/10/2009,3719,3728,3600,3608,-221,252,-75,-44,-111,1,0,9
2511,02/11/2009,3604,3666,3591,3639,80,328,84,492,35,0,1,9
2512,03/11/2009,3603,3608,3550,3584,-46,146,124,224,-19,0,0,9
2513,04/11/2009,3616,3682,3612,3670,-6,-21,280,253,54,0,1,8
2514,05/11/2009,3637,3729,3617,3709,15,30,191,236,72,0,1,9
2515,06/11/2009,3703,3726,3658,3707,134,-79,22,77,4,0,1,9
2516,09/11/2009,3737,3786,3737,3785,150,2,119,271,48,0,1,9
2517,10/11/2009,3789,3803,3775,3786,15,97,-323,-211,-3,1,0,9
2518,11/11/2009,3818,3844,3803,3814,71,40,-152,-41,-4,1,0,9
2519,12/11/2009,3800,3844,3791,3808,51,-88,131,94,8,0,1,9
2520,13/11/2009,3795,3811,3765,3806,345,-177,-155,13,11,0,1,9
2521,16/11/2009,3837,3868,3830,3863,-77,-228,116,-189,26,0,0,9
2522,17/11/2009,3850,3859,3822,3829,57,-53,131,135,-21,0,0,8
2523,18/11/2009,3850,3862,3815,3828,-8,-405,51,-362,-22,1,0,8
2524,19/11/2009,3819,3824,3751,3760,-25,-207,-57,-289,-59,1,0,8
2525,20/11/2009,3772,3788,3714,3729,127,-10,86,203,-43,0,0,8
2526,23/11/2009,3766,3829,3765,3813,51,6,-94,-37,47,0,0,7
2527,24/11/2009,3780,3819,3771,3785,330,-86,119,363,5,0,1,6
2528,25/11/2009,3812,3827,3784,3809,44,153,-105,92,-3,0,0,6
2529,26/11/2009,3788,3793,3673,3679,-234,-116,2,-348,-109,1,0,5
2530,27/11/2009,3613,3748,3611,3721,61,198,218,477,108,0,1,5
2531,30/11/2009,3733,3733,3669,3680,-23,83,-239,-179,-53,1,0,5
2532,01/12/2009,3720,3776,3715,3776,215,277,44,536,56,0,1,6
2533,02/12/2009,3775,3812,3765,3796,129,-160,238,207,21,0,1,7
2534,03/12/2009,3829,3841,3789,3799,105,382,-92,395,-30,0,0,7
2535,04/12/2009,3783,3876,3772,3847,69,164,173,406,64,0,1,6
2536,07/12/2009,3836,3854,3804,3840,-131,-163,-12,-306,4,0,0,7
2537,08/12/2009,3829,3854,3762,3785,-94,-16,-210,-320,-44,1,0,7
2538,09/12/2009,3777,3800,3735,3757,-107,-47,-7,-161,-20,1,0,7
2539,10/12/2009,3757,3805,3753,3798,101,121,-60,162,41,0,1,8
2540,11/12/2009,3795,3837,3795,3804,-437,48,-74,-463,9,0,0,8
2541,14/12/2009,3840,3847,3812,3830,-166,174,10,18,-10,0,0,7
2542,15/12/2009,3835,3843,3794,3834,-233,276,162,205,-1,0,0,6
2543,16/12/2009,3837,3878,3836,3876,62,-106,62,18,39,0,1,5
2544,17/12/2009,3848,3864,3821,3831,-551,51,-47,-547,-17,1,0,5
2545,18/12/2009,3834,3871,3794,3794,-230,-245,-190,-665,-40,1,0,6
2546,21/12/2009,3808,3874,3802,3872,534,210,104,848,64,0,1,6
2547,22/12/2009,3879,3919,3877,3898,-47,184,86,223,19,0,1,7
2548,23/12/2009,3923,3931,3899,3911,-503,-25,62,-466,-12,1,0,7
2549,24/12/2009,3909,3923,3909,3913,-587,65,-110,-632,4,0,0,7
2550,28/12/2009,3940,3952,3934,3947,-465,-211,-171,-847,7,0,0,6
2551,29/12/2009,3959,3977,3950,3960,-418,87,-31,-362,1,0,0,6
2552,30/12/2009,3953,3967,3928,3936,-418,-219,-12,-649,-17,1,0,6
2553,31/12/2009,3953,3959,3936,3936,194,-293,-142,-241,-17,1,0,7
2554,04/01/2010,3952,4014,3951,4014,88,-35,1,54,62,0,1,7
2555,05/01/2010,4012,4028,3993,4013,-421,-6,-65,-492,1,0,0,7
2556,06/01/2010,4014,4023,3997,4018,4,17,18,39,4,0,1,6
2557,07/01/2010,4006,4032,3984,4025,-378,-32,-115,-525,19,0,0,6
2558,08/01/2010,4043,4051,4013,4045,-477,164,-18,-331,2,0,0,5
2559,11/01/2010,4071,4088,4039,4043,-511,-281,-64,-856,-28,1,0,4
2560,12/01/2010,4044,4049,3980,4000,88,-158,-25,-95,-44,1,0,5
2561,13/01/2010,3980,4008,3979,4001,18,180,-168,30,21,0,1,6
2562,14/01/2010,4029,4030,3994,4016,-119,-421,-208,-748,-13,1,0,7
2563,15/01/2010,4031,4044,3950,3954,11,58,-171,-102,-77,1,0,7
2564,18/01/2010,3971,3983,3954,3977,-145,-36,65,-116,6,0,0,7
2565,19/01/2010,3969,4020,3931,4010,-40,244,-180,24,41,0,1,6
2566,20/01/2010,3996,4013,3916,3929,-187,-188,-168,-543,-67,1,0,7
2567,21/01/2010,3956,3966,3862,3862,9,-2,-196,-189,-94,1,0,7
2568,22/01/2010,3840,3860,3786,3821,28,-28,194,194,-19,0,0,8
2569,25/01/2010,3794,3833,3780,3782,54,51,182,287,-12,0,0,8
2570,26/01/2010,3748,3807,3741,3807,59,137,59,255,59,0,1,7
2571,27/01/2010,3770,3794,3737,3760,-21,234,-109,104,-10,0,0,7
2572,28/01/2010,3812,3812,3689,3689,-130,-48,-69,-247,-123,1,0,6
2573,29/01/2010,3712,3768,3696,3739,27,-27,27,27,27,0,1,6
2574,01/02/2010,3713,3774,3702,3762,66,-41,57,82,49,0,1,6
2575,02/02/2010,3767,3819,3738,3812,335,-142,111,304,45,0,1,7
2576,03/02/2010,3820,3831,3784,3793,57,5,-127,-65,-27,1,0,7
2577,04/02/2010,3792,3806,3686,3689,-118,48,-116,-186,-103,1,0,7
2578,05/02/2010,3666,3674,3564,3564,108,52,-233,-73,-102,1,0,7
2579,08/02/2010,3595,3617,3546,3607,-144,-765,-176,-1085,12,0,0,8
2580,09/02/2010,3599,3634,3584,3613,310,234,50,594,14,0,1,8
2581,10/02/2010,3638,3674,3618,3636,-74,122,89,137,-2,0,0,8
2582,11/02/2010,3660,3676,3582,3617,191,25,206,422,-43,0,0,8
2583,12/02/2010,3647,3661,3579,3599,-300,-67,-73,-440,-48,1,0,7
2584,15/02/2010,3621,3642,3600,3609,128,94,-119,103,-12,0,0,7
2585,16/02/2010,3641,3669,3602,3669,290,53,-39,304,28,0,1,6
2586,17/02/2010,3707,3749,3700,3725,-232,96,-70,-206,18,0,0,6
2587,18/02/2010,3719,3752,3711,3748,371,32,366,769,29,0,1,5
2588,19/02/2010,3712,3773,3707,3770,57,-53,80,84,58,0,1,5
2589,22/02/2010,3781,3782,3753,3757,69,-150,9,-72,-24,1,0,5
2590,23/02/2010,3780,3792,3696,3707,-261,52,-73,-282,-73,1,0,6
2591,24/02/2010,3713,3728,3684,3716,57,198,-14,241,3,0,1,6
2592,25/02/2010,3695,3725,3634,3641,-14,-67,-14,-95,-54,1,0,7
2593,26/02/2010,3681,3710,3648,3709,163,63,-94,132,28,0,1,8
2594,01/03/2010,3740,3772,3725,3770,5,-60,5,-50,30,0,0,8
2595,02/03/2010,3771,3812,3763,3812,11,74,41,126,41,0,1,8
2596,03/03/2010,3799,3850,3788,3843,-418,-53,-83,-554,44,0,0,8
2597,04/03/2010,3813,3851,3810,3828,-421,76,-273,-618,15,0,0,8
2598,05/03/2010,3846,3910,3838,3910,4,52,114,170,64,0,1,7
2599,08/03/2010,3924,3924,3902,3904,39,-17,-113,-91,-20,1,0,7
2600,09/03/2010,3908,3920,3876,3910,68,-24,78,122,2,0,1,7
2601,10/03/2010,3908,3951,3902,3944,-514,17,-81,-578,36,0,0,7
2602,11/03/2010,3921,3946,3910,3929,-204,-25,-39,-268,8,0,0,6
2603,12/03/2010,3934,3956,3919,3927,4,52,114,170,-7,0,0,5
2604,15/03/2010,3921,3926,3889,3891,46,-45,-210,-209,-30,1,0,4
2605,16/03/2010,3914,3951,3911,3939,-62,-188,19,-231,25,0,0,5
2606,17/03/2010,3954,3968,3943,3958,-499,-15,104,-410,4,0,0,4
2607,18/03/2010,3937,3965,3923,3938,-275,-254,76,-453,1,0,0,4
2608,19/03/2010,3953,3964,3906,3925,-302,-358,-168,-828,-28,1,0,4
2609,22/03/2010,3909,3928,3868,3928,-43,-428,-138,-609,19,0,0,4
2610,23/03/2010,3928,3962,3927,3953,8,55,-138,-75,25,0,0,3
2611,24/03/2010,3960,3967,3908,3950,-82,108,-82,-56,-10,1,0,2
2612,25/03/2010,3952,4009,3951,4000,360,282,-234,408,48,0,1,3
2613,26/03/2010,3991,4003,3980,3989,-551,-167,-149,-867,-2,1,0,4
2614,29/03/2010,4002,4018,3971,4001,194,343,55,592,-1,0,0,5
2615,30/03/2010,4018,4029,3979,3987,-332,340,-107,-99,-31,1,0,4
2616,31/03/2010,3982,3999,3943,3974,186,171,-84,273,-8,0,0,5
2617,01/04/2010,3997,4042,3990,4034,39,289,110,438,37,0,1,5
2618,06/04/2010,4049,4065,4027,4054,-436,-275,-75,-786,5,0,0,6
2619,07/04/2010,4049,4052,4020,4027,-610,85,-85,-610,-22,1,0,5
2620,08/04/2010,4007,4012,3952,3978,40,-155,-182,-297,-29,1,0,6
2621,09/04/2010,4008,4051,4008,4051,534,210,104,848,43,0,1,7
2622,12/04/2010,4078,4082,4032,4050,53,4,49,106,-28,0,0,7
2623,13/04/2010,4039,4058,4021,4032,-437,-45,-178,-660,-7,1,0,6
2624,14/04/2010,4052,4074,4047,4058,409,369,-168,610,6,0,1,6
2625,15/04/2010,4069,4085,4037,4066,120,320,23,463,-3,0,0,7
2626,16/04/2010,4045,4086,3976,3987,120,-105,-36,-21,-58,1,0,6
2627,19/04/2010,3965,3987,3949,3970,5,-118,189,76,5,0,1,7
2628,20/04/2010,3988,4030,3971,4027,80,84,113,277,39,0,1,7
2629,21/04/2010,4037,4037,3977,3978,73,-50,83,106,-59,0,0,8
2630,22/04/2010,3970,4007,3907,3925,-272,285,-53,-40,-45,1,0,7
2631,23/04/2010,3922,3968,3907,3951,-91,-185,-42,-318,29,0,0,7
2632,26/04/2010,3995,4018,3978,3997,-36,-88,-95,-219,2,0,0,6
2633,27/04/2010,3989,3996,3845,3845,-158,-140,-211,-509,-144,1,0,6
2634,28/04/2010,3815,3848,3750,3787,-156,62,30,-64,-28,1,0,6
2635,29/04/2010,3796,3858,3775,3841,80,328,84,492,45,0,1,6
2636,30/04/2010,3830,3857,3784,3817,287,-69,-150,68,-13,0,0,7
2637,03/05/2010,3797,3847,3772,3828,108,156,-182,82,31,0,1,6
2638,04/05/2010,3827,3836,3679,3689,-397,-439,-272,-1108,-138,1,0,6
2639,05/05/2010,3688,3705,3614,3636,34,-938,34,-870,-52,1,0,6
2640,06/05/2010,3584,3668,3542,3556,52,63,75,190,-28,0,0,7
2641,07/05/2010,3455,3539,3350,3393,-62,-737,-162,-961,-62,1,0,6
2642,10/05/2010,3606,3720,3462,3720,-199,114,114,29,114,0,1,7
2643,11/05/2010,3655,3700,3623,3693,4,41,55,100,38,0,1,8
2644,12/05/2010,3666,3763,3639,3734,108,-241,58,-75,68,0,0,8
2645,13/05/2010,3774,3774,3703,3732,-79,-40,-342,-461,-42,1,0,7
2646,14/05/2010,3707,3711,3544,3560,-75,-209,-223,-507,-147,1,0,7
2647,17/05/2010,3527,3595,3515,3544,-212,17,-148,-343,17,0,0,8
2648,18/05/2010,3601,3640,3576,3617,222,215,155,592,16,0,1,7
2649,19/05/2010,3557,3576,3486,3512,-115,-17,50,-82,-45,1,0,7
2650,20/05/2010,3522,3556,3362,3433,-286,-89,-170,-545,-89,1,0,7
2651,21/05/2010,3433,3459,3342,3431,95,-2,27,120,-2,0,0,8
2652,24/05/2010,3460,3478,3400,3431,216,28,84,328,-29,0,0,7
2653,25/05/2010,3327,3349,3288,3331,-305,-260,-5,-570,4,0,0,6
2654,26/05/2010,3393,3450,3375,3409,221,217,106,544,16,0,1,5
2655,27/05/2010,3433,3528,3421,3525,633,19,38,690,92,0,1,6
2656,28/05/2010,3553,3553,3501,3515,-110,207,41,138,-38,0,0,6
2657,31/05/2010,3506,3529,3498,3508,-100,-104,-193,-397,2,0,0,5
2658,01/06/2010,3482,3521,3414,3503,-11,-151,-187,-349,21,0,0,5
2659,02/06/2010,3472,3506,3432,3502,80,183,27,290,30,0,1,4
2660,03/06/2010,3573,3598,3550,3557,47,-78,27,-4,-16,1,0,4
2661,04/06/2010,3568,3593,3443,3456,-49,-301,72,-278,-112,1,0,4
2662,07/06/2010,3397,3455,3382,3414,63,-45,125,143,17,0,1,5
2663,08/06/2010,3434,3434,3344,3380,-43,-89,-424,-556,-54,1,0,6
2664,09/06/2010,3412,3447,3365,3447,208,35,-182,61,35,0,1,7
2665,10/06/2010,3417,3539,3405,3517,180,57,-4,233,100,0,1,7
2666,11/06/2010,3537,3570,3508,3556,-11,195,177,361,19,0,1,7
2667,14/06/2010,3583,3630,3582,3626,-46,-130,91,-85,43,0,0,8
2668,15/06/2010,3591,3673,3591,3662,-351,-61,-120,-532,71,0,0,8
2669,16/06/2010,3690,3690,3639,3676,93,-21,-14,58,-14,0,0,8
2670,17/06/2010,3672,3716,3660,3683,-7,11,49,53,11,0,1,7
2671,18/06/2010,3685,3705,3663,3687,39,-47,-79,-87,2,0,0,7
2672,21/06/2010,3751,3760,3722,3736,-350,-53,53,-350,-15,1,0,6
2673,22/06/2010,3703,3726,3671,3705,98,-36,-36,26,2,0,1,6
2674,23/06/2010,3666,3696,3627,3642,-10,-261,-69,-340,-24,1,0,6
2675,24/06/2010,3666,3668,3543,3555,-92,-192,58,-226,-111,1,0,6
2676,25/06/2010,3559,3578,3504,3520,-150,-34,-39,-223,-39,1,0,6
2677,28/06/2010,3538,3578,3507,3576,141,115,-75,181,38,0,1,6
2678,29/06/2010,3520,3532,3425,3433,-183,-12,-136,-331,-87,1,0,7
2679,30/06/2010,3448,3471,3409,3443,114,-5,-5,104,-5,0,0,8
2680,01/07/2010,3387,3403,3321,3340,58,68,-47,79,-47,0,0,8
2681,02/07/2010,3372,3391,3337,3348,-24,218,-95,99,-24,0,0,7
2682,05/07/2010,3363,3365,3332,3332,-31,-184,-66,-281,-31,1,0,7
2683,06/07/2010,3352,3456,3350,3423,-96,420,-96,228,71,0,1,7
2684,07/07/2010,3386,3483,3361,3483,-135,232,273,370,97,0,1,7
2685,08/07/2010,3516,3554,3505,3538,-150,-18,-37,-205,22,0,0,7
2686,09/07/2010,3567,3571,3540,3554,39,367,9,415,-13,0,0,6
2687,12/07/2010,3563,3593,3546,3568,5,140,25,170,5,0,1,5
2688,13/07/2010,3568,3643,3568,3638,57,-143,92,6,70,0,1,5
2689,14/07/2010,3652,3657,3596,3633,-11,7,-19,-23,-19,1,0,5
2690,15/07/2010,3617,3654,3569,3582,-175,84,34,-57,-35,1,0,6
2691,16/07/2010,3595,3615,3487,3500,-46,-263,-84,-393,-95,1,0,7
2692,19/07/2010,3476,3534,3476,3486,207,63,114,384,10,0,1,8
2693,20/07/2010,3512,3514,3420,3468,27,16,-152,-109,-44,1,0,8
2694,21/07/2010,3500,3542,3489,3494,-125,-13,-147,-285,-6,1,0,8
2695,22/07/2010,3473,3605,3469,3601,-115,38,-197,-274,128,0,0,8
2696,23/07/2010,3596,3628,3575,3607,3,8,-298,-287,11,0,0,8
2697,26/07/2010,3635,3636,3590,3636,-9,-158,-298,-465,1,0,0,8
2698,27/07/2010,3661,3698,3654,3666,16,-167,-28,-179,5,0,0,7
2699,28/07/2010,3681,3700,3656,3670,-455,-2,-100,-557,-11,1,0,6
2700,29/07/2010,3680,3721,3652,3652,-455,95,80,-280,-28,1,0,6
2701,30/07/2010,3647,3680,3601,3643,1,-114,-96,-209,-4,1,0,6
2702,02/08/2010,3676,3756,3672,3752,60,35,-67,28,76,0,1,6
2703,03/08/2010,3745,3752,3716,3748,-254,-36,-132,-422,3,0,0,6
2704,04/08/2010,3747,3780,3716,3761,-248,-158,-135,-541,14,0,0,5
2705,05/08/2010,3764,3803,3759,3764,-106,-39,30,-115,0,0,0,4
2706,06/08/2010,3781,3794,3698,3716,-445,-301,-225,-971,-65,1,0,4
2707,09/08/2010,3764,3782,3753,3777,-135,-208,371,28,13,0,1,5
2708,10/08/2010,3769,3772,3710,3731,-425,34,-41,-432,-38,1,0,6
2709,11/08/2010,3705,3709,3626,3628,-283,-224,-97,-604,-77,1,0,7
2710,12/08/2010,3611,3642,3584,3621,38,-177,-57,-196,10,0,0,7
2711,13/08/2010,3650,3652,3578,3611,-150,44,-82,-188,-39,1,0,6
2712,16/08/2010,3623,3629,3564,3598,75,-45,-92,-62,-25,1,0,6
2713,17/08/2010,3615,3665,3610,3663,-292,-120,-82,-494,48,0,0,6
2714,18/08/2010,3651,3668,3625,3648,97,-41,104,160,-3,0,0,6
2715,19/08/2010,3667,3680,3570,3572,-114,-129,-58,-301,-95,1,0,6
2716,20/08/2010,3570,3596,3517,3526,-247,-229,-202,-678,-44,1,0,7
2717,23/08/2010,3537,3583,3525,3553,194,-8,144,330,16,0,1,7
2718,24/08/2010,3523,3530,3457,3491,1,89,-426,-336,-32,1,0,7
2719,25/08/2010,3483,3501,3415,3450,108,-320,122,-90,-33,1,0,7
2720,26/08/2010,3491,3492,3456,3475,196,-175,13,34,-16,0,0,7
2721,27/08/2010,3460,3510,3436,3507,5,-38,-27,-60,47,0,0,7
2722,30/08/2010,3519,3521,3477,3487,-256,-45,197,-104,-32,1,0,6
2723,31/08/2010,3435,3491,3431,3491,67,89,277,433,56,0,1,6
2724,01/09/2010,3508,3626,3479,3624,45,9,140,194,116,0,1,7
2725,02/09/2010,3610,3646,3598,3631,38,60,88,186,21,0,1,8
2726,03/09/2010,3642,3706,3631,3672,109,-53,88,144,30,0,1,8
2727,06/09/2010,3695,3695,3675,3685,-159,-127,-68,-354,-10,1,0,8
2728,07/09/2010,3669,3673,3620,3644,-77,-174,-68,-319,-25,1,0,8
2729,08/09/2010,3633,3687,3613,3677,284,143,224,651,44,0,1,8
2730,09/09/2010,3667,3731,3655,3722,70,61,15,146,55,0,1,8
2731,10/09/2010,3703,3732,3697,3726,-340,-112,11,-441,23,0,0,9
2732,13/09/2010,3765,3781,3752,3767,-334,121,-45,-258,2,0,0,9
2733,14/09/2010,3767,3784,3747,3774,-441,-58,46,-453,7,0,0,8
2734,15/09/2010,3776,3784,3738,3756,-399,-97,-8,-504,-20,1,0,7
2735,16/09/2010,3758,3766,3730,3736,-50,207,153,310,-22,0,0,7
2736,17/09/2010,3778,3795,3705,3722,-62,-30,-82,-174,-56,1,0,6
2737,20/09/2010,3738,3792,3737,3788,-62,39,-188,-211,50,0,0,6
2738,21/09/2010,3782,3825,3778,3784,-465,-86,-150,-701,2,0,0,5
2739,22/09/2010,3797,3797,3730,3735,128,-160,36,4,-62,0,0,4
2740,23/09/2010,3762,3772,3666,3711,226,-114,-38,74,-51,0,0,3
2741,24/09/2010,3688,3786,3686,3782,127,393,152,672,94,0,1,2
2742,27/09/2010,3797,3801,3764,3766,-298,-7,-61,-366,-31,1,0,3
2743,28/09/2010,3751,3780,3711,3762,279,-354,-132,-207,11,0,0,4
2744,29/09/2010,3781,3798,3726,3737,-159,-169,0,-328,-44,1,0,4
2745,30/09/2010,3712,3783,3693,3715,5,-65,169,109,3,0,1,4
2746,01/10/2010,3723,3754,3673,3692,54,107,151,312,-31,0,0,5
2747,04/10/2010,3689,3692,3640,3650,-74,-44,-193,-311,-39,1,0,4
2748,05/10/2010,3649,3743,3638,3732,215,277,44,536,83,0,1,5
2749,06/10/2010,3751,3780,3747,3765,64,-115,-14,-65,14,0,0,6
2750,07/10/2010,3769,3800,3732,3770,-328,-40,-2,-370,1,0,0,6
2751,08/10/2010,3763,3775,3739,3763,69,17,-24,62,0,0,0,6
2752,11/10/2010,3770,3782,3764,3768,150,-110,-106,-66,-2,1,0,5
2753,12/10/2010,3738,3756,3700,3749,-23,-109,-24,-156,11,0,0,5
2754,13/10/2010,3769,3828,3767,3828,-108,-135,-117,-360,59,0,0,5
2755,14/10/2010,3833,3845,3812,3819,-64,-333,131,-266,-14,1,0,4
2756,15/10/2010,3830,3838,3799,3827,163,-112,108,159,-3,0,0,4
2757,18/10/2010,3803,3842,3798,3834,105,37,146,288,31,0,1,4
2758,19/10/2010,3829,3854,3795,3807,-428,-312,-63,-803,-22,1,0,4
2759,20/10/2010,3793,3833,3786,3828,-270,75,106,-89,35,0,0,4
2760,21/10/2010,3821,3890,3811,3878,72,295,92,459,57,0,1,4
2761,22/10/2010,3859,3888,3856,3869,-441,-6,-54,-501,10,0,0,5
2762,25/10/2010,3895,3895,3863,3870,-30,-225,-60,-315,-25,1,0,5
2763,26/10/2010,3855,3866,3819,3853,66,8,-4,70,-2,0,0,5
2764,27/10/2010,3836,3868,3811,3816,-202,-28,-344,-574,-20,1,0,5
2765,28/10/2010,3838,3863,3822,3835,-65,253,131,319,-3,0,0,6
2766,29/10/2010,3829,3858,3808,3834,68,-81,20,7,5,0,1,5
2767,01/11/2010,3865,3874,3812,3841,-30,-47,-4,-81,-24,1,0,6
2768,02/11/2010,3830,3879,3830,3866,-158,-103,-208,-469,36,0,0,6
2769,03/11/2010,3880,3891,3835,3843,-133,-281,296,-118,-37,1,0,5
2770,04/11/2010,3885,3932,3885,3917,-14,-90,180,76,32,0,1,6
2771,05/11/2010,3928,3938,3894,3917,-378,105,58,-215,-11,1,0,6
2772,08/11/2010,3915,3920,3897,3914,-477,-105,-126,-708,-1,1,0,7
2773,09/11/2010,3904,3962,3903,3946,27,94,-207,-86,42,0,0,7
2774,10/11/2010,3923,3933,3869,3888,-343,-222,-11,-576,-35,1,0,7
2775,11/11/2010,3901,3903,3848,3867,-283,80,-70,-273,-34,1,0,7
2776,12/11/2010,3797,3853,3770,3831,226,377,82,685,34,0,1,8
2777,15/11/2010,3810,3876,3798,3864,242,-76,-6,160,54,0,1,8
2778,16/11/2010,3837,3842,3762,3762,60,117,60,237,-75,0,0,8
2779,17/11/2010,3754,3799,3753,3792,-241,-51,249,-43,38,0,0,8
2780,18/11/2010,3824,3874,3822,3868,-244,-8,55,-197,44,0,0,7
2781,19/11/2010,3872,3872,3827,3860,-212,-157,-186,-555,-12,1,0,6
2782,22/11/2010,3893,3896,3812,3819,-194,75,-191,-310,-74,1,0,6
2783,23/11/2010,3792,3804,3724,3724,-97,32,-62,-127,-68,1,0,6
2784,24/11/2010,3738,3761,3704,3748,9,-364,10,-345,10,0,0,7
2785,25/11/2010,3752,3768,3730,3760,-246,219,-159,-186,8,0,0,6
2786,26/11/2010,3729,3744,3687,3729,-18,-43,196,135,0,0,0,5
2787,29/11/2010,3748,3774,3637,3637,-232,-361,-159,-752,-111,1,0,4
2788,30/11/2010,3644,3657,3592,3610,-44,-22,-50,-116,-34,1,0,4
2789,01/12/2010,3635,3675,3621,3669,-60,-193,-57,-310,34,0,0,5
2790,02/12/2010,3695,3755,3650,3747,92,69,236,397,52,0,1,5
2791,03/12/2010,3744,3776,3721,3751,57,-58,-122,-123,7,0,0,6
2792,06/12/2010,3759,3763,3723,3749,-159,37,-173,-295,-10,1,0,5
2793,07/12/2010,3760,3835,3759,3810,-212,-151,-155,-518,50,0,0,5
2794,08/12/2010,3790,3858,3784,3832,457,157,68,682,42,0,1,4
2795,09/12/2010,3858,3867,3837,3858,20,-61,32,-9,0,0,0,5
2796,10/12/2010,3870,3874,3851,3857,41,-13,-3,25,-13,0,0,5
2797,13/12/2010,3873,3904,3869,3892,49,-198,3,-146,19,0,0,5
2798,14/12/2010,3894,3903,3882,3903,-252,36,-60,-276,9,0,0,4
2799,15/12/2010,3890,3893,3865,3880,-421,-190,-301,-912,-10,1,0,3
2800,16/12/2010,3878,3897,3861,3888,-151,134,-118,-135,10,0,0,4
2801,17/12/2010,3901,3906,3865,3867,85,-13,-41,31,-34,0,0,3
2802,20/12/2010,3873,3919,3869,3885,-69,-175,97,-147,12,0,0,3
2803,21/12/2010,3903,3936,3899,3927,-35,-54,123,34,24,0,1,2
2804,22/12/2010,3923,3932,3919,3920,-428,154,-51,-325,-3,1,0,3
2805,23/12/2010,3923,3924,3889,3911,173,-110,105,168,-12,0,0,3
2806,24/12/2010,3907,3912,3894,3900,-92,418,-182,144,-7,0,0,3
2807,27/12/2010,3893,3902,3836,3862,20,-178,-203,-361,-31,1,0,3
2808,28/12/2010,3873,3882,3859,3859,79,244,104,427,-14,0,0,4
2809,29/12/2010,3870,3904,3870,3891,-209,90,171,52,21,0,1,4
2810,30/12/2010,3894,3902,3840,3851,-188,-207,-138,-533,-43,1,0,4
2811,31/12/2010,3854,3854,3805,3805,107,131,-26,212,-49,0,0,5
2812,03/01/2011,3848,3904,3837,3901,-218,328,-277,-167,53,0,0,5
2813,04/01/2011,3908,3946,3891,3916,-70,-160,-206,-436,8,0,0,5
2814,05/01/2011,3904,3906,3850,3905,-47,-40,193,106,1,0,1,4
2815,06/01/2011,3911,3945,3896,3904,46,-89,152,109,-7,0,0,4
2816,07/01/2011,3893,3914,3866,3866,-384,82,152,-150,-27,1,0,4
2817,10/01/2011,3850,3853,3791,3802,-59,10,-60,-109,-48,1,0,5
2818,11/01/2011,3822,3867,3810,3862,-21,-23,-156,-200,40,0,0,5
2819,12/01/2011,3871,3946,3870,3945,49,-110,73,12,74,0,1,5
2820,13/01/2011,3951,3976,3944,3975,-503,270,29,-204,24,0,0,5
2821,14/01/2011,3961,3992,3954,3983,-106,351,-195,50,22,0,1,4
2822,17/01/2011,3984,3990,3966,3975,-271,101,28,-142,-9,1,0,5
2823,18/01/2011,3991,4016,3987,4013,-15,-298,52,-261,22,0,0,6
2824,19/01/2011,4020,4023,3973,3977,-334,-89,-46,-469,-43,1,0,6
2825,20/01/2011,3973,3989,3950,3965,-75,68,-255,-262,-8,1,0,6
2826,21/01/2011,3982,4058,3979,4017,72,159,216,447,35,0,1,7
2827,24/01/2011,4028,4038,4003,4033,-587,-1,36,-552,5,0,0,7
2828,25/01/2011,4049,4057,4016,4020,-551,-200,-50,-801,-29,1,0,6
2829,26/01/2011,4044,4066,4040,4049,40,-40,47,47,5,0,1,7
2830,27/01/2011,4040,4079,4032,4060,-428,-32,284,-176,20,0,0,7
2831,28/01/2011,4045,4073,4002,4002,-445,34,51,-360,-43,1,0,7
2832,31/01/2011,3997,4019,3953,4006,-34,-4,108,70,9,0,1,7
2833,01/02/2011,4037,4078,4019,4073,-121,28,-4,-97,36,0,0,7
2834,02/02/2011,4085,4090,4050,4067,-526,-107,-101,-734,-18,1,0,7
2835,03/02/2011,4056,4059,4009,4037,280,-154,102,228,-19,0,0,7
2836,04/02/2011,4049,4060,4027,4047,18,-239,180,-41,-2,1,0,6
2837,07/02/2011,4056,4099,4053,4091,-178,244,81,147,35,0,1,6
2838,08/02/2011,4082,4109,4079,4108,-347,259,-77,-165,26,0,0,7
2839,09/02/2011,4101,4120,4091,4091,-563,-95,-102,-760,-10,1,0,6
2840,10/02/2011,4079,4095,4042,4095,144,455,-1,598,16,0,1,6
2841,11/02/2011,4081,4121,4039,4101,110,-96,-20,-6,20,0,0,7
2842,14/02/2011,4129,4130,4090,4097,288,-260,-102,-74,-32,1,0,6
2843,15/02/2011,4092,4119,4086,4110,-44,379,-273,62,18,0,1,6
2844,16/02/2011,4124,4170,4121,4151,-23,172,158,307,27,0,1,7
2845,17/02/2011,4161,4163,4130,4152,-477,164,-18,-331,-9,1,0,7
2846,18/02/2011,4165,4169,4136,4157,-428,-26,-178,-632,-8,1,0,8
2847,21/02/2011,4153,4164,4088,4097,-248,184,31,-33,-56,1,0,8
2848,22/02/2011,4075,4079,4026,4050,5,159,107,271,-25,0,0,8
2849,23/02/2011,4045,4061,4008,4013,107,-395,36,-252,-32,1,0,8
2850,24/02/2011,3985,4024,3984,4010,-231,25,184,-22,25,0,0,8
2851,25/02/2011,4029,4085,4007,4070,133,169,264,566,41,0,1,7
2852,28/02/2011,4065,4132,4053,4110,-263,-221,60,-424,45,0,0,8
2853,01/03/2011,4127,4146,4056,4067,-84,-160,-108,-352,-60,1,0,7
2854,02/03/2011,4043,4054,4010,4034,-32,-239,-9,-280,-9,1,0,7
2855,03/03/2011,4058,4098,4040,4061,-179,355,-101,75,3,0,1,7
2856,04/03/2011,4069,4091,4011,4020,-28,132,-49,55,-49,0,0,7
2857,07/03/2011,4007,4050,3990,3990,-119,46,-14,-87,-17,1,0,6
2858,08/03/2011,4006,4017,3965,4016,4,-57,96,43,10,0,1,6
2859,09/03/2011,4016,4036,3986,3994,158,-188,142,112,-22,0,0,7
2860,10/03/2011,3961,3981,3940,3964,-111,-43,141,-13,3,0,0,6
2861,11/03/2011,3927,3951,3915,3929,-70,-31,-174,-275,2,0,0,6
2862,14/03/2011,3914,3940,3871,3878,-61,-185,81,-165,-36,1,0,5
2863,15/03/2011,3794,3821,3713,3781,57,-14,-44,-1,-13,1,0,6
2864,16/03/2011,3801,3801,3694,3697,-134,-902,-134,-1170,-104,1,0,6
2865,17/03/2011,3729,3797,3708,3786,-74,-602,-40,-716,57,0,0,6
2866,18/03/2011,3808,3862,3801,3810,24,193,68,285,2,0,1,5
2867,21/03/2011,3871,3904,3855,3904,-100,-89,254,65,33,0,1,6
2868,22/03/2011,3904,3927,3877,3893,-25,-29,-264,-318,-11,1,0,6
2869,23/03/2011,3875,3918,3875,3914,32,-174,-281,-423,39,0,0,6
2870,24/03/2011,3900,3973,3886,3969,117,-324,-62,-269,69,0,0,6
2871,25/03/2011,3987,3987,3960,3972,-213,-68,-51,-332,-15,1,0,6
2872,28/03/2011,3967,3991,3960,3977,113,40,-51,102,10,0,1,7
2873,29/03/2011,3984,3991,3949,3988,34,-195,88,-73,4,0,0,7
2874,30/03/2011,4024,4031,4012,4024,354,-147,-155,52,0,0,0,6
2875,31/03/2011,4026,4037,3989,3989,-219,-208,-47,-474,-37,1,0,5
2876,01/04/2011,4015,4056,4002,4055,-110,38,118,46,40,0,1,6
2877,04/04/2011,4051,4060,4040,4043,-106,78,-100,-128,-8,1,0,6
2878,05/04/2011,4040,4045,4014,4042,-174,27,4,-143,2,0,0,6
2879,06/04/2011,4046,4067,4016,4048,215,-285,248,178,2,0,1,5
2880,07/04/2011,4049,4071,4025,4028,85,-54,78,109,-21,0,0,6
2881,08/04/2011,4052,4069,4048,4062,-2,-109,6,-105,10,0,0,6
2882,11/04/2011,4057,4058,4026,4039,-123,-112,-82,-317,-18,1,0,5
2883,12/04/2011,4008,4019,3966,3977,-339,-226,42,-523,-31,1,0,5
2884,13/04/2011,3998,4029,3984,4006,251,104,144,499,8,0,1,6
2885,14/04/2011,3986,3995,3949,3970,77,-72,11,16,-16,0,0,7
2886,15/04/2011,3971,3978,3950,3974,-75,29,30,-16,3,0,0,6
2887,18/04/2011,3971,3971,3862,3881,-227,364,46,183,-90,0,0,5
2888,19/04/2011,3900,3929,3895,3909,127,-28,-66,33,9,0,1,4
2889,20/04/2011,3947,4009,3947,4005,36,106,26,168,58,0,1,5
2890,21/04/2011,4022,4034,4011,4022,-136,-104,95,-145,0,0,0,5
2891,26/04/2011,4014,4048,4010,4045,90,-61,76,105,31,0,1,5
2892,27/04/2011,4048,4084,4036,4068,-75,-208,48,-235,20,0,0,6
2893,28/04/2011,4095,4108,4080,4105,-399,203,-37,-233,10,0,0,5
2894,29/04/2011,4094,4110,4084,4107,-413,-53,-149,-615,13,0,0,4
2895,02/05/2011,4138,4138,4109,4109,-388,-209,-64,-661,-29,1,0,3
2896,03/05/2011,4105,4108,4071,4097,-106,162,15,71,-8,0,0,4
2897,04/05/2011,4090,4117,4032,4043,-15,-60,-114,-189,-47,1,0,4
2898,05/05/2011,4039,4052,3981,4005,-121,55,-23,-89,-34,1,0,5
2899,06/05/2011,4008,4064,3992,4058,228,-99,-114,15,50,0,1,5
2900,09/05/2011,4038,4058,3994,4007,4,-71,-23,-90,-31,1,0,5
2901,10/05/2011,4011,4072,4007,4053,-45,-176,-111,-332,42,0,0,6
2902,11/05/2011,4062,4077,4048,4058,-99,113,-72,-58,-4,1,0,5
2903,12/05/2011,4016,4025,3987,4023,-196,67,-94,-223,7,0,0,6
2904,13/05/2011,4046,4068,4011,4019,54,91,-2,143,-27,0,0,6
2905,16/05/2011,3975,3998,3956,3990,-30,204,-10,164,15,0,1,6
2906,17/05/2011,3973,4004,3942,3942,128,-60,-52,16,-31,0,0,6
2907,18/05/2011,3977,3991,3956,3978,-158,349,-44,147,1,0,1,6
2908,19/05/2011,4001,4046,3978,4028,132,107,23,262,27,0,1,6
2909,20/05/2011,4023,4051,3983,3991,-72,-404,93,-383,-32,1,0,6
2910,23/05/2011,3934,3937,3904,3907,23,-214,-81,-272,-27,1,0,6
2911,24/05/2011,3915,3935,3907,3917,30,-286,128,-128,2,0,0,6
2912,25/05/2011,3890,3938,3885,3929,181,191,229,601,39,0,1,6
2913,26/05/2011,3937,3949,3904,3917,161,-43,98,216,-20,0,0,6
2914,27/05/2011,3959,3979,3941,3951,54,-12,-89,-47,-8,1,0,6
2915,30/05/2011,3947,3963,3932,3943,-83,-36,92,-27,-4,1,0,7
2916,31/05/2011,3968,4015,3960,4007,-152,138,-91,-105,39,0,0,7
2917,01/06/2011,4015,4016,3956,3965,-100,-171,-35,-306,-50,1,0,7
2918,02/06/2011,3931,3937,3890,3890,108,33,-82,59,-41,0,0,7
2919,03/06/2011,3899,3906,3845,3891,475,-57,301,719,-8,0,0,6
2920,06/06/2011,3876,3882,3852,3863,166,235,339,740,-13,0,0,5
2921,07/06/2011,3864,3890,3856,3872,31,8,-38,1,8,0,1,4
2922,08/06/2011,3858,3864,3826,3838,315,-26,-36,253,-20,0,0,5
2923,09/06/2011,3835,3885,3823,3879,-125,52,123,50,44,0,1,4
2924,10/06/2011,3866,3877,3799,3805,-114,6,-224,-332,-61,1,0,5
2925,13/06/2011,3807,3828,3796,3808,123,-93,89,119,1,0,1,5
2926,14/06/2011,3831,3878,3830,3865,-291,-107,-207,-605,34,0,0,5
2927,15/06/2011,3851,3859,3800,3807,108,-241,58,-75,-44,1,0,5
2928,16/06/2011,3775,3795,3744,3792,290,-12,210,488,17,0,1,5
2929,17/06/2011,3775,3843,3742,3824,-89,-207,11,-285,49,0,0,6
2930,20/06/2011,3759,3807,3755,3800,-38,-42,-82,-162,41,0,0,6
2931,21/06/2011,3820,3879,3820,3877,-15,160,140,285,57,0,1,6
2932,22/06/2011,3875,3885,3854,3871,60,-79,-166,-185,-4,1,0,6
2933,23/06/2011,3852,3858,3774,3788,136,-174,-91,-129,-64,1,0,7
2934,24/06/2011,3838,3867,3775,3785,-33,-122,-201,-356,-53,1,0,7
2935,27/06/2011,3776,3803,3770,3797,-7,-122,201,72,21,0,1,7
2936,28/06/2011,3811,3868,3806,3852,160,-32,343,471,41,0,1,7
2937,29/06/2011,3876,3936,3869,3924,-102,-38,53,-87,48,0,0,8
2938,30/06/2011,3937,3982,3926,3982,426,269,-13,682,45,0,1,7
2939,01/07/2011,3982,4024,3967,4007,-270,3,-9,-276,25,0,0,7
2940,04/07/2011,4010,4010,3997,4003,98,0,125,223,-7,0,0,7
2941,05/07/2011,3997,3999,3974,3979,42,-68,-105,-131,-18,1,0,7
2942,06/07/2011,3981,3982,3942,3961,-58,-262,-56,-376,-20,1,0,7
2943,07/07/2011,3982,4020,3960,3980,-47,94,-110,-63,-2,1,0,7
2944,08/07/2011,3995,3999,3913,3914,-270,-36,-110,-416,-81,1,0,7
2945,11/07/2011,3879,3890,3790,3808,-263,-42,14,-291,-71,1,0,7
2946,12/07/2011,3742,3787,3718,3774,5,36,32,73,32,0,1,7
2947,13/07/2011,3756,3801,3748,3793,-1,229,276,504,37,0,1,7
2948,14/07/2011,3755,3782,3744,3751,91,-255,133,-31,-4,1,0,8
2949,15/07/2011,3730,3748,3707,3727,-3,-197,6,-194,-3,1,0,8
2950,18/07/2011,3698,3699,3646,3651,-33,49,95,111,-47,0,0,9
2951,19/07/2011,3671,3705,3665,3695,-62,-848,-62,-972,24,0,0,9
2952,20/07/2011,3725,3759,3710,3755,-21,146,-122,3,30,0,1,8
2953,21/07/2011,3770,3840,3712,3817,167,164,191,522,47,0,1,8
2954,22/07/2011,3855,3866,3818,3843,8,-116,92,-16,-12,1,0,8
2955,25/07/2011,3814,3845,3808,3813,157,41,176,374,-1,0,0,8
2956,26/07/2011,3819,3835,3768,3788,68,118,92,278,-31,0,0,7
2957,27/07/2011,3775,3777,3711,3734,135,-292,147,-10,-41,1,0,6
2958,28/07/2011,3707,3721,3669,3713,-149,-2,142,-9,6,0,0,6
2959,29/07/2011,3661,3691,3631,3673,260,123,153,536,12,0,1,5
2960,01/08/2011,3718,3723,3586,3588,-120,-271,-94,-485,-130,1,0,5
2961,02/08/2011,3568,3592,3523,3523,493,18,351,862,-45,0,0,6
2962,03/08/2011,3473,3519,3441,3455,17,217,-163,71,-18,0,0,6
2963,04/08/2011,3515,3515,3315,3320,-195,-737,-195,-1127,-195,1,0,5
2964,05/08/2011,3218,3390,3218,3279,112,303,112,527,61,0,1,5
2965,08/08/2011,3254,3334,3125,3125,-129,94,-129,-164,-129,1,0,5
2966,09/08/2011,3132,3202,2980,3176,44,44,44,132,44,0,1,6
2967,10/08/2011,3236,3236,3001,3003,-357,-233,-233,-823,-233,1,0,7
2968,11/08/2011,3102,3102,2891,3090,-12,-12,-12,-36,-12,1,0,7
2969,12/08/2011,3095,3217,3017,3214,-143,168,119,144,119,0,1,8
2970,15/08/2011,3248,3260,3201,3239,-86,-171,-124,-381,-9,1,0,8
2971,16/08/2011,3216,3231,3162,3231,-70,115,-34,11,15,0,1,8
2972,17/08/2011,3211,3289,3182,3254,-9,-12,68,47,43,0,1,9
2973,18/08/2011,3217,3224,3048,3076,-148,-298,-256,-702,-141,1,0,10
2974,19/08/2011,3061,3078,2948,3017,362,-44,-148,170,-44,0,0,10
2975,22/08/2011,2990,3114,2990,3051,111,61,-75,97,61,0,1,9
2976,23/08/2011,3089,3137,3051,3084,111,124,-27,208,-5,0,0,9
2977,24/08/2011,3115,3167,3075,3140,171,-119,131,183,25,0,1,8
2978,25/08/2011,3168,3189,3097,3119,-154,219,-123,-58,-49,1,0,8
2979,26/08/2011,3114,3122,3014,3088,-70,17,25,-28,-26,1,0,8
2980,29/08/2011,3141,3174,3118,3154,171,-2,-145,24,13,0,1,8
2981,30/08/2011,3187,3193,3129,3160,-102,0,-166,-268,-27,1,0,8
2982,31/08/2011,3179,3263,3165,3257,-110,-225,154,-181,78,0,0,8
2983,01/09/2011,3273,3296,3207,3266,-70,-21,-7,-98,-7,1,0,7
2984,02/09/2011,3227,3227,3133,3149,-48,-18,-131,-197,-78,1,0,7
2985,05/09/2011,3073,3083,2977,3000,-25,53,5,33,-73,0,0,8
2986,06/09/2011,2998,3043,2943,2966,-32,49,-32,-15,-32,1,0,7
2987,07/09/2011,3039,3073,3016,3073,34,544,34,612,34,0,1,8
2988,08/09/2011,3071,3116,3044,3086,-423,53,-94,-464,15,0,0,8
2989,09/09/2011,3065,3077,2967,2975,-158,160,11,13,-90,0,0,7
2990,12/09/2011,2880,2894,2821,2855,-63,-25,-25,-113,-25,1,0,6
2991,13/09/2011,2910,2910,2770,2895,26,218,-15,229,-15,0,0,6
2992,14/09/2011,2852,2957,2850,2949,127,311,276,714,97,0,1,5
2993,15/09/2011,2969,3087,2961,3046,271,-99,-301,-129,77,0,0,6
2994,16/09/2011,3084,3084,3014,3031,7,-79,-54,-126,-53,1,0,5
2995,19/09/2011,2961,2978,2922,2940,117,-311,-137,-331,-21,1,0,5
2996,20/09/2011,2918,2991,2910,2984,-18,-141,-86,-245,66,0,0,6
2997,21/09/2011,2983,2983,2930,2936,-121,13,189,81,-47,0,0,5
2998,22/09/2011,2858,2864,2771,2782,-93,-146,-77,-316,-76,1,0,4
2999,23/09/2011,2821,2824,2693,2810,-92,420,12,340,-11,0,0,5
3000,26/09/2011,2755,2917,2753,2859,138,196,124,458,104,0,1,5
3001,27/09/2011,2943,3023,2910,3023,-126,-218,269,-75,80,0,0,5
3002,28/09/2011,2990,3056,2969,2996,368,351,68,787,6,0,1,5
3003,29/09/2011,2978,3060,2975,3028,209,-155,-11,43,50,0,1,5
3004,30/09/2011,3009,3022,2948,2982,457,157,68,682,-27,0,0,6
3005,03/10/2011,2913,2946,2889,2927,-77,-132,-35,-244,14,0,0,5
3006,04/10/2011,2885,2885,2808,2851,131,-20,-162,-51,-34,1,0,4
3007,05/10/2011,2921,2974,2888,2974,126,10,-119,17,53,0,1,5
3008,06/10/2011,3000,3075,2995,3075,-8,20,147,159,75,0,1,6
3009,07/10/2011,3074,3126,3052,3096,135,-19,92,208,22,0,1,6
3010,10/10/2011,3121,3163,3094,3161,-125,21,63,-41,40,0,0,7
3011,11/10/2011,3152,3156,3115,3154,93,49,16,158,2,0,1,6
3012,12/10/2011,3137,3238,3121,3230,147,-90,127,184,93,0,1,7
3013,13/10/2011,3213,3252,3168,3187,-163,-48,-48,-259,-26,1,0,7
3014,14/10/2011,3201,3250,3180,3218,198,17,-120,95,17,0,1,7
3015,17/10/2011,3242,3267,3150,3166,-76,-18,-120,-214,-76,1,0,8
3016,18/10/2011,3125,3152,3088,3141,-53,156,46,149,16,0,1,9
3017,19/10/2011,3166,3184,3137,3157,-156,-239,-188,-583,-9,1,0,9
3018,20/10/2011,3108,3148,3082,3084,124,-69,-138,-83,-24,1,0,9
3019,21/10/2011,3110,3171,3092,3171,-186,31,72,-83,61,0,0,9
3020,24/10/2011,3191,3224,3156,3220,-221,-115,-171,-507,29,0,0,8
3021,25/10/2011,3202,3228,3150,3174,-33,-225,-255,-513,-28,1,0,8
3022,26/10/2011,3168,3228,3146,3170,-87,114,185,212,2,0,1,8
3023,27/10/2011,3301,3373,3244,3369,117,-316,142,-57,68,0,0,8
3024,28/10/2011,3379,3411,3333,3349,-163,-30,-64,-257,-30,1,0,7
3025,31/10/2011,3303,3310,3243,3243,-6,-99,-88,-193,-60,1,0,7
3026,01/11/2011,3163,3182,3057,3068,79,-4,-71,4,-95,0,0,7
3027,02/11/2011,3118,3135,3050,3111,-7,8,-7,-6,-7,1,0,6
3028,03/11/2011,3040,3222,3029,3195,133,331,105,569,155,0,1,6
3029,04/11/2011,3220,3228,3113,3124,-194,20,-41,-215,-96,1,0,6
3030,07/11/2011,3088,3144,3053,3104,-244,-196,54,-386,16,0,0,7
3031,08/11/2011,3105,3194,3103,3143,106,-170,-39,-103,38,0,0,7
3032,09/11/2011,3170,3183,3046,3075,-181,-47,-31,-259,-95,1,0,6
3033,10/11/2011,3011,3122,3009,3065,177,54,-60,171,54,0,1,6
3034,11/11/2011,3070,3155,3057,3149,215,-153,80,142,79,0,1,7
3035,14/11/2011,3169,3174,3090,3109,144,-75,16,85,-60,0,0,7
3036,15/11/2011,3082,3098,3030,3049,65,-296,-106,-337,-33,1,0,6
3037,16/11/2011,3039,3102,3027,3065,-207,16,-124,-315,26,0,0,7
3038,17/11/2011,3053,3064,3001,3010,-294,159,-39,-174,-43,1,0,6
3039,18/11/2011,2990,3026,2980,2997,83,-5,232,310,7,0,1,6
3040,21/11/2011,2982,2982,2895,2895,216,-78,-74,64,-87,0,0,6
3041,22/11/2011,2925,2942,2871,2871,63,371,-120,314,-54,0,0,6
3042,23/11/2011,2840,2882,2822,2822,44,420,-29,435,-18,0,0,6
3043,24/11/2011,2850,2876,2807,2822,68,-884,11,-805,-28,1,0,5
3044,25/11/2011,2823,2871,2793,2857,470,420,328,1218,34,0,1,5
3045,28/11/2011,2897,3013,2891,3013,48,302,199,549,116,0,1,5
3046,29/11/2011,2996,3048,2972,3027,190,270,108,568,31,0,1,6
3047,30/11/2011,2992,3167,2986,3155,292,351,68,711,163,0,1,6
3048,01/12/2011,3151,3169,3120,3130,125,-21,-41,63,-21,0,0,7
3049,02/12/2011,3167,3201,3151,3165,-69,-119,-127,-315,-2,1,0,6
3050,05/12/2011,3207,3216,3184,3201,-77,-93,-6,-176,-6,1,0,6
3051,06/12/2011,3173,3208,3168,3180,4,7,-32,-21,7,0,0,7
3052,07/12/2011,3225,3245,3132,3176,-101,-54,50,-105,-49,1,0,7
3053,08/12/2011,3202,3216,3091,3095,-178,-192,-194,-564,-107,1,0,8
3054,09/12/2011,3066,3176,3065,3172,-234,111,180,57,106,0,1,8
3055,12/12/2011,3151,3164,3090,3090,-473,-125,30,-568,-61,1,0,8
3056,13/12/2011,3097,3111,3059,3079,-58,78,-69,-49,-18,1,0,8
3057,14/12/2011,3057,3073,2976,2976,-444,-139,-449,-1032,-81,1,0,8
3058,15/12/2011,2990,3022,2975,2999,46,-93,16,-31,9,0,0,8
3059,16/12/2011,3010,3017,2969,2972,138,-94,10,54,-38,0,0,8
3060,19/12/2011,2942,3010,2941,2974,28,-8,-155,-135,32,0,0,7
3061,20/12/2011,2967,3055,2957,3055,16,44,147,207,88,0,1,6
3062,21/12/2011,3080,3121,3020,3030,77,-302,155,-70,-50,1,0,7
3063,22/12/2011,3047,3080,3047,3072,81,-133,200,148,25,0,1,7
3064,23/12/2011,3102,3114,3086,3102,75,372,59,506,0,0,0,7
3065,27/12/2011,3111,3132,3098,3103,-110,-215,-35,-360,-8,1,0,6
3066,28/12/2011,3102,3131,3071,3071,-94,-193,-181,-468,-31,1,0,6
3067,29/12/2011,3081,3128,3065,3128,136,219,-51,304,47,0,1,6
3068,30/12/2011,3140,3160,3120,3160,-98,-170,-42,-310,20,0,0,6
3069,02/01/2012,3158,3222,3157,3222,328,-89,-69,170,64,0,1,6
3070,03/01/2012,3231,3247,3194,3245,-351,69,11,-271,14,0,0,7
3071,04/01/2012,3227,3243,3186,3194,-116,-90,-90,-296,-33,1,0,7
3072,05/01/2012,3197,3200,3137,3145,-174,-103,-114,-391,-52,1,0,7
3073,06/01/2012,3156,3184,3123,3137,18,-65,-340,-387,-19,1,0,7
3074,09/01/2012,3144,3157,3114,3128,93,83,-210,-34,-16,1,0,7
3075,10/01/2012,3154,3219,3154,3211,-130,195,-76,-11,57,0,0,8
3076,11/01/2012,3204,3236,3181,3205,178,50,-105,123,1,0,1,7
3077,12/01/2012,3211,3253,3190,3200,99,233,-271,61,-11,0,0,7
3078,13/01/2012,3224,3244,3152,3196,-258,-3,-116,-377,-28,1,0,6
3079,16/01/2012,3174,3231,3164,3225,-231,244,-54,-41,51,0,0,7
3080,17/01/2012,3260,3293,3243,3270,82,318,-159,241,10,0,1,6
3081,18/01/2012,3276,3302,3236,3265,-325,-296,-125,-746,-11,1,0,7
3082,19/01/2012,3286,3329,3272,3329,224,-9,-32,183,43,0,1,7
3083,20/01/2012,3336,3337,3305,3322,-153,-51,-12,-216,-14,1,0,7
3084,23/01/2012,3325,3352,3314,3338,-778,157,9,-612,13,0,0,7
3085,24/01/2012,3320,3324,3293,3323,-399,-95,-122,-616,3,0,0,6
3086,25/01/2012,3337,3340,3286,3312,-194,17,-159,-336,-25,1,0,6
3087,26/01/2012,3332,3369,3323,3363,33,320,351,704,31,0,1,6
3088,27/01/2012,3345,3368,3319,3319,-503,-34,-82,-619,-26,1,0,7
3089,30/01/2012,3296,3301,3264,3266,-174,-133,-344,-651,-30,1,0,7
3090,31/01/2012,3292,3325,3289,3299,244,-10,-73,161,7,0,1,8
3091,01/02/2012,3320,3370,3320,3367,-66,-32,169,71,47,0,1,8
3092,02/02/2012,3387,3400,3356,3377,-332,-64,-133,-529,-10,1,0,8
3093,03/02/2012,3371,3428,3361,3428,-428,-153,-164,-745,57,0,0,8
3094,06/02/2012,3412,3412,3381,3405,-277,-158,-251,-686,-7,1,0,7
3095,07/02/2012,3416,3422,3379,3412,-143,-167,-18,-328,-4,1,0,8
3096,08/02/2012,3425,3439,3410,3410,99,226,-104,221,-15,0,0,9
3097,09/02/2012,3419,3449,3413,3425,123,-155,-38,-70,6,0,0,8
3098,10/02/2012,3395,3410,3365,3373,-270,21,-85,-334,-22,1,0,7
3099,13/02/2012,3407,3413,3366,3385,121,-92,-52,-23,-22,1,0,7
3100,14/02/2012,3370,3400,3363,3376,-83,-92,-72,-247,6,0,0,7
3101,15/02/2012,3399,3419,3378,3390,-67,157,154,244,-9,0,0,6
3102,16/02/2012,3366,3393,3353,3393,-118,-113,30,-201,27,0,0,5
3103,17/02/2012,3426,3451,3422,3440,-14,118,14,118,14,0,1,4
3104,20/02/2012,3464,3473,3453,3473,-379,-274,-150,-803,9,0,0,5
3105,21/02/2012,3476,3478,3440,3465,-513,-39,-157,-709,-11,1,0,4
3106,22/02/2012,3473,3478,3444,3447,-151,32,-12,-131,-26,1,0,4
3107,23/02/2012,3438,3469,3425,3447,138,162,-25,275,9,0,1,5
3108,24/02/2012,3465,3475,3451,3467,290,109,8,407,2,0,1,6
3109,27/02/2012,3452,3452,3412,3441,-521,-160,4,-677,-11,1,0,6
3110,28/02/2012,3455,3463,3426,3454,318,-282,-61,-25,-1,1,0,6
3111,29/02/2012,3465,3489,3448,3452,-194,-404,-168,-766,-13,1,0,7
3112,01/03/2012,3445,3500,3432,3500,-221,-115,-171,-507,55,0,0,8
3113,02/03/2012,3505,3514,3494,3501,-396,-292,49,-639,-4,1,0,8
3114,05/03/2012,3486,3499,3463,3488,-123,-35,6,-152,2,0,0,8
3115,06/03/2012,3475,3475,3363,3363,111,-51,-64,-4,-112,1,0,8
3116,07/03/2012,3364,3396,3363,3392,38,-434,28,-368,28,0,0,8
3117,08/03/2012,3416,3478,3411,3478,199,-38,62,223,62,0,1,7
3118,09/03/2012,3485,3508,3465,3487,-277,-81,60,-298,2,0,0,7
3119,12/03/2012,3473,3494,3468,3490,59,73,60,192,17,0,1,6
3120,13/03/2012,3509,3551,3509,3550,90,-188,60,-38,41,0,0,6
3121,14/03/2012,3566,3586,3562,3565,-294,111,-56,-239,-1,1,0,5
3122,15/03/2012,3559,3581,3554,3580,-129,-140,-54,-323,21,0,0,5
3123,16/03/2012,3581,3600,3575,3595,-412,-299,117,-594,14,0,0,5
3124,19/03/2012,3581,3581,3563,3578,-421,130,-24,-315,-3,1,0,4
3125,20/03/2012,3564,3566,3524,3531,152,37,-190,-1,-33,1,0,5
3126,21/03/2012,3547,3565,3504,3527,54,171,-198,27,-20,0,0,5
3127,22/03/2012,3515,3519,3457,3472,67,-49,-28,-10,-43,1,0,5
3128,23/03/2012,3473,3491,3433,3476,67,60,-85,42,3,0,1,5
3129,26/03/2012,3496,3510,3458,3502,-93,-176,-138,-407,6,0,0,6
3130,27/03/2012,3516,3536,3465,3470,74,-128,-8,-62,-46,1,0,5
3131,28/03/2012,3456,3485,3430,3430,24,-68,-138,-182,-26,1,0,6
3132,29/03/2012,3426,3435,3375,3381,-298,-170,-18,-486,-45,1,0,6
3133,30/03/2012,3407,3430,3396,3424,72,125,17,214,17,0,1,7
3134,02/04/2012,3439,3463,3398,3463,71,-44,-137,-110,24,0,0,8
3135,03/04/2012,3464,3473,3407,3407,77,-24,-93,-40,-57,1,0,7
3136,04/04/2012,3392,3395,3310,3313,-112,430,4,322,-79,0,0,7
3137,05/04/2012,3326,3339,3279,3320,-13,-264,-19,-296,-6,1,0,7
3138,10/04/2012,3275,3292,3218,3218,-208,-41,-251,-500,-57,1,0,7
3139,11/04/2012,3215,3271,3205,3238,-2,-235,50,-187,23,0,0,7
3140,12/04/2012,3248,3278,3210,3270,-100,-255,17,-338,22,0,0,7
3141,13/04/2012,3265,3268,3180,3189,-231,-1,156,-76,-76,1,0,6
3142,16/04/2012,3183,3246,3183,3205,18,-22,-123,-127,22,0,0,6
3143,17/04/2012,3205,3293,3196,3293,170,-40,3,133,88,0,1,5
3144,18/04/2012,3277,3292,3226,3240,-21,-138,-65,-224,-37,1,0,5
3145,19/04/2012,3253,3280,3174,3174,18,-234,-101,-317,-79,1,0,6
3146,20/04/2012,3178,3204,3155,3189,-61,-77,77,-61,11,0,0,6
3147,23/04/2012,3158,3158,3088,3098,121,107,1,229,-60,0,0,6
3148,24/04/2012,3115,3177,3107,3169,14,-51,165,128,54,0,1,5
3149,25/04/2012,3177,3254,3174,3233,175,64,201,440,56,0,1,5
3150,26/04/2012,3241,3257,3190,3229,-233,-207,36,-404,-12,1,0,6
3151,27/04/2012,3195,3283,3173,3266,-233,42,118,-73,71,0,0,7
3152,30/04/2012,3271,3273,3209,3213,43,-208,-336,-501,-58,1,0,6
3153,02/05/2012,3265,3267,3208,3226,5,-4,120,121,-39,0,0,7
3154,03/05/2012,3242,3274,3208,3223,-99,-372,97,-374,-19,1,0,6
3155,04/05/2012,3211,3229,3154,3162,135,5,36,176,-49,0,0,6
3156,07/05/2012,3112,3219,3104,3214,94,123,268,485,102,0,1,5
3157,08/05/2012,3190,3190,3111,3125,-166,-154,-1,-321,-65,1,0,6
3158,09/05/2012,3138,3147,3076,3119,32,91,80,203,-19,0,0,7
3159,10/05/2012,3136,3145,3073,3130,47,116,74,237,-6,0,0,6
3160,11/05/2012,3108,3135,3077,3130,50,78,4,132,22,0,1,5
3161,14/05/2012,3093,3098,3039,3058,143,-121,-102,-80,-35,1,0,5
3162,15/05/2012,3080,3099,3021,3039,-178,-219,-79,-476,-41,1,0,6
3163,16/05/2012,3017,3082,2998,3049,149,-364,-30,-245,32,0,0,6
3164,17/05/2012,3055,3059,3003,3012,-125,-47,-233,-405,-43,1,0,6
3165,18/05/2012,2981,3032,2970,3008,-44,-286,60,-270,27,0,0,6
3166,21/05/2012,2997,3043,2985,3027,10,-78,-124,-192,30,0,0,6
3167,22/05/2012,3052,3094,3032,3084,57,159,6,222,32,0,1,5
3168,23/05/2012,3050,3054,2994,3003,44,-110,-127,-193,-47,1,0,5
3169,24/05/2012,3029,3053,2988,3038,143,-65,4,82,9,0,1,6
3170,25/05/2012,3045,3071,3016,3048,117,-110,-10,-3,3,0,0,7
3171,28/05/2012,3068,3088,3034,3043,-166,-30,-27,-223,-25,1,0,6
3172,29/05/2012,3059,3100,3037,3085,265,-42,-27,196,26,0,1,6
3173,30/05/2012,3051,3079,3006,3016,-51,-132,24,-159,-35,1,0,6
3174,31/05/2012,3029,3043,2986,3017,42,72,-197,-83,-12,1,0,7
3175,01/06/2012,3028,3028,2922,2950,42,47,-157,-68,-78,1,0,7
3176,04/06/2012,2929,2987,2927,2954,130,-92,-181,-143,25,0,0,8
3177,05/06/2012,2972,2998,2957,2986,-42,278,-8,228,14,0,1,8
3178,06/06/2012,3006,3066,3002,3058,-63,219,-30,126,52,0,1,8
3179,07/06/2012,3071,3105,3063,3071,-183,-61,-155,-399,0,0,0,8
3180,08/06/2012,3044,3063,3018,3052,11,-209,24,-174,8,0,0,7
3181,11/06/2012,3111,3122,3040,3043,-232,-204,-201,-637,-68,1,0,7
3182,12/06/2012,3044,3069,3015,3047,-127,-216,-14,-357,3,0,0,7
3183,13/06/2012,3056,3073,3014,3030,-28,96,-54,14,-26,0,0,6
3184,14/06/2012,3022,3036,2994,3032,448,-89,45,404,10,0,1,5
3185,15/06/2012,3050,3096,3048,3088,-256,-164,45,-375,38,0,0,5
3186,18/06/2012,3121,3129,3054,3066,-422,-445,-118,-985,-55,1,0,4
3187,19/06/2012,3064,3120,3053,3118,-42,206,76,240,54,0,1,5
3188,20/06/2012,3127,3131,3101,3127,-477,-71,252,-296,0,0,0,5
3189,21/06/2012,3111,3153,3100,3114,-436,-16,49,-403,3,0,0,4
3190,22/06/2012,3090,3114,3075,3091,194,-293,-142,-241,1,0,0,4
3191,25/06/2012,3073,3075,3007,3022,-73,-430,-264,-767,-51,1,0,4
3192,26/06/2012,3027,3036,3004,3013,242,11,112,365,-14,0,0,4
3193,27/06/2012,3022,3063,3010,3063,-75,-212,54,-233,41,0,0,4
3194,28/06/2012,3066,3071,3021,3052,-8,-26,87,53,-14,0,0,4
3195,29/06/2012,3139,3197,3112,3197,73,129,131,333,58,0,1,3
3196,02/07/2012,3197,3252,3191,3240,-167,-60,-21,-248,43,0,0,4
3197,03/07/2012,3244,3271,3242,3271,-256,-101,-197,-554,27,0,0,3
3198,04/07/2012,3264,3268,3245,3268,-12,162,3,153,4,0,1,2
3199,05/07/2012,3263,3289,3210,3229,7,-100,125,32,-34,0,0,3
3200,06/07/2012,3214,3227,3169,3169,81,-324,-51,-294,-45,1,0,3
3201,09/07/2012,3167,3176,3139,3157,9,-19,-1,-11,-10,1,0,4
3202,10/07/2012,3167,3205,3152,3175,21,79,60,160,8,0,1,4
3203,11/07/2012,3155,3177,3145,3157,68,55,0,123,2,0,1,5
3204,12/07/2012,3144,3159,3118,3135,74,57,-148,-17,-9,1,0,6
3205,13/07/2012,3148,3181,3137,3181,-77,1,-53,-129,33,0,0,7
3206,16/07/2012,3176,3183,3156,3180,-18,20,-80,-78,4,0,0,6
3207,17/07/2012,3187,3203,3167,3177,76,113,33,222,-10,0,0,6
3208,18/07/2012,3195,3235,3192,3235,125,67,61,253,40,0,1,6
3209,19/07/2012,3247,3268,3238,3264,182,-179,-110,-107,17,0,0,6
3210,20/07/2012,3259,3262,3193,3194,-60,92,-42,-10,-65,1,0,6
3211,23/07/2012,3160,3163,3087,3102,-173,-189,-78,-440,-58,1,0,6
3212,24/07/2012,3114,3120,3075,3075,12,349,-199,162,-39,0,0,6
3213,25/07/2012,3067,3113,3065,3082,30,96,128,254,15,0,1,5
3214,26/07/2012,3095,3207,3072,3207,216,252,112,580,112,0,1,5
3215,27/07/2012,3225,3280,3194,3280,156,259,0,415,55,0,1,5
3216,30/07/2012,3299,3331,3289,3321,-365,111,22,-232,22,0,0,6
3217,31/07/2012,3319,3335,3292,3292,-200,-6,-14,-220,-27,1,0,6
3218,01/08/2012,3299,3328,3297,3322,-778,168,64,-546,23,0,0,7
3219,02/08/2012,3316,3375,3232,3232,-340,-61,-149,-550,-84,1,0,6
3220,03/08/2012,3245,3374,3238,3374,39,5,54,98,129,0,1,7
3221,06/08/2012,3365,3416,3358,3402,-205,-29,58,-176,37,0,0,7
3222,07/08/2012,3400,3453,3399,3453,-103,-18,-24,-145,53,0,0,6
3223,08/08/2012,3439,3452,3421,3438,-132,-53,-9,-194,-1,1,0,6
3224,09/08/2012,3454,3464,3422,3457,-158,-89,-301,-548,3,0,0,6
3225,10/08/2012,3438,3442,3414,3436,-365,156,-52,-261,-2,1,0,5
3226,13/08/2012,3430,3454,3411,3426,58,70,4,132,-4,0,0,5
3227,14/08/2012,3444,3459,3432,3450,111,-293,222,40,6,0,1,5
3228,15/08/2012,3436,3463,3424,3449,-47,207,284,444,13,0,1,5
3229,16/08/2012,3460,3480,3438,3480,-499,-25,78,-446,20,0,0,6
3230,17/08/2012,3492,3502,3475,3488,-275,-62,-67,-404,-4,1,0,5
3231,20/08/2012,3484,3506,3459,3481,-334,-124,-6,-464,-3,1,0,5
3232,21/08/2012,3492,3524,3492,3513,167,233,257,657,21,0,1,6
3233,22/08/2012,3485,3501,3462,3462,-445,-72,-96,-613,-23,1,0,7
3234,23/08/2012,3486,3496,3415,3433,-234,-103,-12,-349,-53,1,0,7
3235,24/08/2012,3432,3442,3397,3433,473,-156,36,353,1,0,1,8
3236,27/08/2012,3423,3463,3415,3463,-95,62,-60,-93,40,0,0,8
3237,28/08/2012,3440,3456,3421,3432,-254,55,-208,-407,-8,1,0,8
3238,29/08/2012,3427,3434,3403,3414,-209,-150,-156,-515,-13,1,0,8
3239,30/08/2012,3405,3414,3372,3379,188,134,-95,227,-26,0,0,8
3240,31/08/2012,3378,3434,3372,3413,123,-2,82,203,35,0,1,8
3241,03/09/2012,3402,3454,3394,3454,119,-156,153,116,52,0,1,8
3242,04/09/2012,3459,3459,3398,3399,-70,-46,5,-111,-60,1,0,8
3243,05/09/2012,3399,3426,3373,3406,-186,-234,-131,-551,7,0,0,8
3244,06/09/2012,3413,3510,3412,3510,18,-15,35,38,97,0,1,7
3245,07/09/2012,3520,3562,3515,3519,-60,111,-180,-129,-1,1,0,7
3246,10/09/2012,3514,3528,3503,3506,-294,-201,-18,-513,-8,1,0,7
3247,11/09/2012,3492,3537,3477,3537,58,26,-42,42,45,0,1,8
3248,12/09/2012,3546,3575,3526,3544,-161,223,-17,45,-2,0,0,8
3249,13/09/2012,3541,3541,3494,3502,-271,143,-82,-210,-39,1,0,7
3250,14/09/2012,3573,3588,3556,3582,189,38,257,484,9,0,1,8
3251,17/09/2012,3559,3574,3553,3554,-56,61,111,116,-5,0,0,8
3252,18/09/2012,3534,3538,3500,3513,-30,-32,-105,-167,-21,1,0,7
3253,19/09/2012,3529,3540,3504,3532,25,-32,-195,-202,3,0,0,7
3254,20/09/2012,3501,3521,3486,3510,73,-100,-216,-243,9,0,0,7
3255,21/09/2012,3528,3541,3505,3531,97,145,4,246,3,0,1,6
3256,24/09/2012,3501,3514,3484,3497,80,-428,-230,-578,-4,1,0,6
3257,25/09/2012,3490,3520,3474,3514,-99,53,14,-32,24,0,0,6
3258,26/09/2012,3472,3473,3415,3415,5,-61,-210,-266,-57,1,0,5
3259,27/09/2012,3437,3447,3421,3439,38,-120,-65,-147,2,0,0,6
3260,28/09/2012,3457,3460,3355,3355,218,-5,-84,129,-102,0,0,5
3261,01/10/2012,3348,3439,3348,3435,-13,-34,115,68,87,0,1,4
3262,02/10/2012,3411,3451,3392,3414,-135,201,273,339,3,0,1,5
3263,03/10/2012,3397,3421,3388,3406,-164,-7,-152,-323,9,0,0,5
3264,04/10/2012,3422,3432,3387,3401,-111,-12,96,-27,-21,1,0,5
3265,05/10/2012,3410,3462,3410,3457,-257,123,187,53,47,0,1,6
3266,08/10/2012,3429,3430,3405,3407,68,-171,-21,-124,-22,1,0,6
3267,09/10/2012,3420,3427,3378,3383,-166,34,50,-82,-37,1,0,6
3268,10/10/2012,3371,3387,3366,3366,-63,-140,119,-84,-5,1,0,7
3269,11/10/2012,3353,3424,3351,3414,24,123,187,334,61,0,1,7
3270,12/10/2012,3401,3419,3389,3389,-166,-164,-1,-331,-12,1,0,8
3271,15/10/2012,3388,3440,3388,3420,-30,-55,50,-35,32,0,0,9
3272,16/10/2012,3444,3501,3429,3501,192,75,-204,63,57,0,1,8
3273,17/10/2012,3504,3531,3494,3528,-219,78,-143,-284,24,0,0,8
3274,18/10/2012,3528,3543,3508,3535,125,-71,0,54,7,0,1,8
3275,19/10/2012,3528,3538,3497,3505,-399,-363,-32,-794,-23,1,0,8
3276,22/10/2012,3498,3519,3476,3483,-146,22,-47,-171,-15,1,0,8
3277,23/10/2012,3486,3492,3391,3406,162,-226,-219,-283,-80,1,0,8
3278,24/10/2012,3422,3434,3389,3426,201,-185,142,158,4,0,1,8
3279,25/10/2012,3428,3457,3409,3412,-326,-100,-2,-428,-16,1,0,8
3280,26/10/2012,3385,3447,3382,3435,-178,141,142,105,50,0,1,8
3281,29/10/2012,3419,3421,3395,3409,-122,-24,-112,-258,-10,1,0,8
3282,30/10/2012,3415,3462,3415,3459,-44,-95,74,-65,44,0,0,9
3283,31/10/2012,3459,3485,3429,3429,-165,39,185,59,-30,0,0,8
3284,01/11/2012,3420,3484,3414,3475,86,145,48,279,55,0,1,8
3285,02/11/2012,3481,3503,3458,3492,-6,-226,71,-161,11,0,0,8
3286,05/11/2012,3470,3474,3448,3448,134,90,-298,-74,-22,1,0,7
3287,06/11/2012,3456,3480,3447,3479,-234,-202,-74,-510,23,0,0,7
3288,07/11/2012,3513,3516,3410,3410,69,69,51,189,-103,0,0,6
3289,08/11/2012,3434,3441,3400,3408,-93,107,-59,-45,-26,1,0,5
3290,09/11/2012,3411,3433,3374,3424,-74,317,13,256,13,0,1,5
3291,12/11/2012,3425,3428,3404,3412,-151,-214,-13,-378,-13,1,0,5
3292,13/11/2012,3392,3434,3374,3431,-31,-110,11,-130,39,0,0,5
3293,14/11/2012,3425,3436,3395,3400,117,33,-41,109,-25,0,0,5
3294,15/11/2012,3379,3401,3374,3382,259,-160,28,127,3,0,1,5
3295,16/11/2012,3380,3393,3342,3342,142,-133,11,20,-38,0,0,5
3296,19/11/2012,3375,3444,3370,3440,-61,-77,77,-61,65,0,0,5
3297,20/11/2012,3425,3464,3416,3462,-6,-23,-171,-200,37,0,0,4
3298,21/11/2012,3454,3484,3445,3477,17,205,147,369,23,0,1,4
3299,22/11/2012,3489,3500,3481,3498,157,1,145,303,9,0,1,5
3300,23/11/2012,3505,3529,3482,3529,-544,-91,50,-585,24,0,0,5
3301,26/11/2012,3514,3522,3494,3501,-445,85,-37,-397,-13,1,0,4
3302,27/11/2012,3521,3531,3491,3502,-192,-48,-110,-350,-19,1,0,4
3303,28/11/2012,3490,3520,3479,3515,46,25,-136,-65,25,0,0,5
3304,29/11/2012,3537,3569,3533,3569,-51,59,-199,-191,32,0,0,5
3305,30/11/2012,3568,3585,3557,3557,-64,233,126,295,-11,0,0,4
3306,03/12/2012,3568,3603,3563,3567,-151,-445,221,-375,-1,1,0,4
3307,04/12/2012,3563,3597,3563,3580,46,47,204,297,17,0,1,5
3308,05/12/2012,3602,3607,3575,3590,-389,-68,284,-173,-12,1,0,6
3309,06/12/2012,3598,3621,3585,3602,-498,8,-25,-515,4,0,0,6
3310,07/12/2012,3607,3622,3590,3606,-445,-106,153,-398,-1,1,0,5
3311,10/12/2012,3587,3614,3576,3612,-432,142,-48,-338,25,0,0,6
3312,11/12/2012,3619,3649,3609,3646,-248,98,134,-16,27,0,0,5
3313,12/12/2012,3646,3652,3636,3647,-425,90,37,-298,1,0,0,4
3314,13/12/2012,3654,3659,3633,3643,-498,-169,-210,-877,-11,1,0,4
3315,14/12/2012,3644,3653,3632,3643,280,-25,108,363,-1,0,0,5
3316,17/12/2012,3633,3640,3611,3638,72,382,372,826,5,0,1,5
3317,18/12/2012,3650,3656,3632,3649,9,-281,349,77,-1,0,0,5
3318,19/12/2012,3662,3670,3650,3665,177,-243,75,9,3,0,1,4
3319,20/12/2012,3652,3675,3652,3667,63,372,71,506,15,0,1,4
3320,21/12/2012,3650,3667,3638,3661,1,142,45,188,11,0,1,5
3321,24/12/2012,3663,3671,3650,3653,-270,345,-111,-36,-10,1,0,5
3322,27/12/2012,3652,3684,3652,3674,126,-50,-37,39,22,0,1,6
3323,28/12/2012,3677,3680,3619,3620,167,-247,71,-9,-57,1,0,7
3324,31/12/2012,3600,3657,3599,3641,83,90,127,300,41,0,1,8
3325,02/01/2013,3703,3734,3693,3734,-72,-87,77,-82,31,0,0,8
3326,03/01/2013,3724,3727,3704,3721,-445,-232,-21,-698,-3,1,0,8
3327,04/01/2013,3713,3731,3697,3730,-215,-95,-26,-336,17,0,0,8
3328,07/01/2013,3731,3733,3697,3705,147,-95,-337,-285,-26,1,0,8
3329,08/01/2013,3694,3731,3693,3706,164,171,345,680,12,0,1,8
3330,09/01/2013,3722,3730,3704,3717,-140,-176,-156,-472,-5,1,0,8
3331,10/01/2013,3716,3727,3694,3703,67,121,-50,138,-13,0,0,8
3332,11/01/2013,3709,3714,3684,3706,-159,-169,0,-328,-3,1,0,7
3333,14/01/2013,3722,3730,3704,3708,-133,-151,22,-262,-14,1,0,7
3334,15/01/2013,3697,3718,3689,3697,-194,219,38,63,0,0,0,7
3335,16/01/2013,3694,3715,3681,3708,154,-104,51,101,14,0,1,6
3336,17/01/2013,3709,3754,3705,3744,117,-41,52,128,35,0,1,7
3337,18/01/2013,3758,3761,3736,3742,-9,0,-14,-23,-16,1,0,7
3338,21/01/2013,3748,3763,3739,3763,179,-15,-150,14,15,0,1,8
3339,22/01/2013,3759,3763,3725,3741,-275,237,-38,-76,-18,1,0,8
3340,23/01/2013,3743,3752,3714,3726,-178,126,-182,-234,-17,1,0,8
3341,24/01/2013,3723,3752,3712,3752,126,53,-165,14,29,0,1,8
3342,25/01/2013,3746,3783,3745,3778,5,123,-43,85,32,0,1,9
3343,28/01/2013,3785,3789,3771,3781,-248,78,55,-115,-4,1,0,9
3344,29/01/2013,3780,3790,3763,3786,-259,320,-23,38,6,0,1,9
3345,30/01/2013,3787,3793,3759,3766,120,320,23,463,-21,0,0,10
3346,31/01/2013,3755,3761,3726,3733,-283,-68,-10,-361,-22,1,0,9
3347,01/02/2013,3735,3786,3732,3774,450,-102,39,387,39,0,1,9
3348,04/02/2013,3778,3778,3660,3660,-8,-175,106,-77,-118,1,0,9
3349,05/02/2013,3654,3711,3654,3695,165,-93,-106,-34,41,0,0,9
3350,06/02/2013,3695,3707,3624,3643,-6,53,-102,-55,-52,1,0,8
3351,07/02/2013,3639,3660,3601,3601,-134,-390,-59,-583,-38,1,0,8
3352,08/02/2013,3615,3654,3608,3650,276,-264,95,107,35,0,1,8
3353,11/02/2013,3660,3676,3635,3651,-213,-187,53,-347,-9,1,0,8
3354,12/02/2013,3645,3687,3640,3687,79,-141,26,-36,42,0,0,8
3355,13/02/2013,3692,3709,3673,3699,117,75,189,381,7,0,1,7
3356,14/02/2013,3692,3710,3658,3670,173,76,-90,159,-22,0,0,8
3357,15/02/2013,3666,3695,3659,3660,-25,159,174,308,-6,0,0,7
3358,18/02/2013,3656,3669,3641,3667,-70,32,174,136,11,0,1,6
3359,19/02/2013,3662,3740,3661,3736,134,-84,39,89,74,0,1,6
3360,20/02/2013,3734,3744,3702,3710,-5,-114,33,-86,-24,1,0,7
3361,21/02/2013,3687,3688,3623,3625,136,-2,-210,-76,-62,1,0,7
3362,22/02/2013,3646,3707,3645,3706,143,44,149,336,60,0,1,7
3363,25/02/2013,3721,3788,3705,3721,-245,-10,-43,-298,0,0,0,7
3364,26/02/2013,3610,3668,3601,3622,-34,239,-166,39,12,0,1,6
3365,27/02/2013,3642,3693,3619,3691,-255,-176,53,-378,49,0,0,7
3366,28/02/2013,3712,3728,3685,3723,-118,-57,36,-139,11,0,0,6
3367,01/03/2013,3712,3732,3661,3700,-212,-54,-97,-363,-12,1,0,6
3368,04/03/2013,3681,3724,3673,3710,313,11,36,360,29,0,1,7
3369,05/03/2013,3738,3793,3737,3787,-70,379,-72,237,49,0,1,7
3370,06/03/2013,3792,3809,3770,3774,-106,-62,-162,-330,-18,1,0,7
3371,07/03/2013,3783,3802,3780,3794,65,-14,62,113,11,0,1,7
3372,08/03/2013,3814,3850,3813,3840,-544,-253,-34,-831,26,0,0,7
3373,11/03/2013,3831,3838,3818,3836,-556,-154,-64,-774,5,0,0,6
3374,12/03/2013,3824,3855,3823,3840,-791,116,15,-660,16,0,0,6
3375,13/03/2013,3834,3840,3818,3836,-430,-9,-21,-460,2,0,0,5
3376,14/03/2013,3855,3872,3850,3872,-151,134,-118,-135,17,0,0,5
3377,15/03/2013,3869,3869,3830,3844,-343,-174,-206,-723,-25,1,0,5
3378,18/03/2013,3768,3832,3761,3825,-25,-25,152,102,57,0,1,5
3379,19/03/2013,3813,3819,3764,3776,-107,-103,-201,-411,-37,1,0,5
3380,20/03/2013,3798,3835,3786,3830,214,46,-62,198,32,0,1,5
3381,21/03/2013,3821,3823,3757,3775,-156,-316,38,-434,-46,1,0,5
3382,22/03/2013,3766,3791,3750,3770,-90,-221,-97,-408,4,0,0,5
3383,25/03/2013,3824,3837,3719,3728,-10,7,-106,-109,-96,1,0,5
3384,26/03/2013,3735,3765,3732,3749,125,252,2,379,14,0,1,6
3385,27/03/2013,3763,3766,3669,3712,-288,323,-92,-57,-51,1,0,7
3386,28/03/2013,3711,3751,3695,3731,200,186,-277,109,20,0,1,8
3387,02/04/2013,3730,3810,3729,3805,128,229,65,422,75,0,1,9
3388,03/04/2013,3790,3806,3753,3755,23,321,80,424,-35,0,0,9
3389,04/04/2013,3768,3795,3719,3726,186,-113,-23,50,-42,0,0,8
3390,05/04/2013,3728,3736,3639,3663,1,-85,-30,-114,-65,1,0,7
3391,08/04/2013,3677,3694,3663,3667,12,-41,-122,-151,-10,1,0,7
3392,09/04/2013,3688,3702,3656,3671,-86,319,-136,97,-17,0,0,7
3393,10/04/2013,3685,3750,3685,3744,476,-7,160,629,59,0,1,7
3394,11/04/2013,3740,3789,3737,3776,33,-96,-66,-129,36,0,0,7
3395,12/04/2013,3766,3774,3718,3729,-218,-209,-35,-462,-37,1,0,6
3396,15/04/2013,3729,3748,3685,3710,-168,86,-64,-146,-19,1,0,6
3397,16/04/2013,3695,3722,3676,3686,117,15,52,184,-9,0,0,6
3398,17/04/2013,3707,3711,3591,3599,96,-86,-174,-164,-108,1,0,5
3399,18/04/2013,3617,3637,3584,3599,-212,-399,19,-592,-18,1,0,6
3400,19/04/2013,3633,3658,3614,3652,146,-321,-92,-267,19,0,0,7
3401,22/04/2013,3673,3682,3632,3652,113,6,39,158,-21,0,0,6
3402,23/04/2013,3656,3783,3655,3783,-72,164,242,334,127,0,1,5
3403,24/04/2013,3786,3849,3783,3843,80,372,364,816,57,0,1,6
3404,25/04/2013,3835,3854,3826,3840,12,30,18,60,5,0,1,6
3405,26/04/2013,3822,3828,3788,3810,147,-111,-9,27,-12,0,0,7
3406,29/04/2013,3828,3870,3828,3869,209,-24,64,249,41,0,1,6
3407,30/04/2013,3883,3886,3843,3857,-256,-74,-18,-348,-26,1,0,6
3408,02/05/2013,3829,3889,3819,3859,-145,-195,-168,-508,30,0,0,7
3409,03/05/2013,3874,3915,3848,3913,40,192,116,348,39,0,1,6
3410,06/05/2013,3909,3916,3898,3907,-535,-260,-311,-1106,-2,1,0,6
3411,07/05/2013,3915,3941,3905,3921,1,-90,-116,-205,6,0,0,7
3412,08/05/2013,3924,3957,3919,3956,-505,-103,4,-604,32,0,0,7
3413,09/05/2013,3927,3942,3909,3929,-244,-144,-157,-545,2,0,0,6
3414,10/05/2013,3932,3972,3930,3954,64,-293,-92,-321,22,0,0,5
3415,13/05/2013,3948,3962,3933,3945,99,252,3,354,-3,0,0,4
3416,14/05/2013,3950,3966,3922,3966,142,-45,4,101,16,0,1,4
3417,15/05/2013,3959,3983,3951,3982,-249,0,18,-231,23,0,0,4
3418,16/05/2013,3968,3984,3958,3979,-498,-169,-210,-877,11,0,0,3
3419,17/05/2013,3968,4019,3962,4001,144,14,351,509,33,0,1,3
3420,20/05/2013,4006,4023,3993,4023,-432,235,-108,-305,17,0,0,3
3421,21/05/2013,4010,4036,3991,4036,-465,72,-67,-460,26,0,0,2
3422,22/05/2013,4036,4059,4009,4051,-551,-167,-149,-867,15,0,0,2
3423,23/05/2013,3956,3984,3940,3967,-511,-281,-64,-856,11,0,0,2
3424,24/05/2013,3982,3997,3942,3957,41,-8,11,44,-25,0,0,2
3425,27/05/2013,3979,3998,3976,3995,77,352,107,536,16,0,1,2
3426,28/05/2013,4006,4072,4004,4051,8,-146,40,-98,45,0,0,3
3427,29/05/2013,4025,4029,3970,3974,-432,-22,-28,-482,-51,1,0,2
3428,30/05/2013,3964,4019,3964,3996,36,-156,80,-40,32,0,0,3
3429,31/05/2013,3996,3996,3938,3949,-109,-105,-57,-271,-47,1,0,3
3430,03/06/2013,3930,3980,3889,3921,201,154,-60,295,-9,0,0,3
3431,04/06/2013,3950,3962,3920,3926,131,-5,82,208,-24,0,0,3
3432,05/06/2013,3904,3916,3852,3852,-90,-88,-83,-261,-52,1,0,3
3433,06/06/2013,3861,3878,3814,3814,98,-429,-30,-361,-47,1,0,4
3434,07/06/2013,3821,3890,3801,3873,132,68,133,333,52,0,1,5
3435,10/06/2013,3864,3885,3854,3864,-209,89,8,-112,0,0,0,6
3436,11/06/2013,3850,3850,3780,3811,-97,-214,53,-258,-39,1,0,5
3437,12/06/2013,3805,3835,3792,3794,184,-264,80,0,-11,0,0,6
3438,13/06/2013,3748,3804,3732,3798,-41,-480,313,-208,50,0,0,5
3439,14/06/2013,3823,3831,3794,3805,-263,89,0,-174,-18,1,0,5
3440,17/06/2013,3815,3883,3815,3864,-68,-45,153,40,49,0,1,5
3441,18/06/2013,3849,3871,3837,3861,119,-176,147,90,12,0,1,6
3442,19/06/2013,3866,3868,3824,3839,5,-61,147,91,-27,0,0,7
3443,20/06/2013,3778,3783,3696,3699,-125,-15,-104,-244,-79,1,0,6
3444,21/06/2013,3719,3744,3658,3658,-123,-28,-100,-251,-61,1,0,6
3445,24/06/2013,3653,3668,3575,3596,-88,41,-37,-84,-57,1,0,6
3446,25/06/2013,3643,3656,3619,3650,39,-765,11,-715,7,0,0,7
3447,26/06/2013,3655,3731,3638,3726,-4,56,-16,36,71,0,1,6
3448,27/06/2013,3722,3781,3704,3762,160,519,-135,544,40,0,1,7
3449,28/06/2013,3767,3775,3724,3739,82,5,-27,60,-28,0,0,8
3450,01/07/2013,3762,3786,3725,3767,-154,-4,96,-62,5,0,0,7
3451,02/07/2013,3776,3776,3731,3743,-212,42,-19,-189,-33,1,0,6
3452,03/07/2013,3708,3709,3669,3702,203,-292,-28,-117,-6,1,0,6
3453,04/07/2013,3734,3810,3723,3809,108,56,95,259,75,0,1,7
3454,05/07/2013,3811,3837,3754,3754,-249,89,-129,-289,-57,1,0,7
3455,08/07/2013,3782,3843,3782,3824,-232,-204,119,-317,42,0,0,7
3456,09/07/2013,3841,3859,3832,3844,27,-50,69,46,3,0,1,6
3457,10/07/2013,3841,3855,3812,3841,-84,-16,69,-31,0,0,0,7
3458,11/07/2013,3885,3888,3855,3869,73,-115,27,-15,-16,1,0,6
3459,12/07/2013,3879,3886,3845,3855,-294,-109,-122,-525,-24,1,0,6
3460,15/07/2013,3867,3893,3863,3879,-143,-72,4,-211,12,0,0,7
3461,16/07/2013,3883,3885,3847,3851,-610,-62,-168,-840,-32,1,0,7
3462,17/07/2013,3859,3883,3822,3872,179,-236,8,-49,13,0,0,7
3463,18/07/2013,3864,3928,3859,3928,130,-56,105,179,64,0,1,6
3464,19/07/2013,3915,3925,3900,3925,-418,-149,164,-403,10,0,0,6
3465,22/07/2013,3929,3946,3916,3940,-194,17,-159,-336,11,0,0,5
3466,23/07/2013,3953,3956,3923,3923,-436,-275,-75,-786,-30,1,0,5
3467,24/07/2013,3931,3976,3931,3963,121,321,20,462,32,0,1,5
3468,25/07/2013,3962,3968,3920,3956,-378,-46,-146,-570,-6,1,0,6
3469,26/07/2013,3980,4002,3961,3969,-75,50,-48,-73,-11,1,0,6
3470,29/07/2013,3989,3998,3962,3969,-428,95,-101,-434,-20,1,0,6
3471,30/07/2013,3984,3998,3966,3987,-379,-124,36,-467,3,0,0,7
3472,31/07/2013,3975,4007,3965,3993,-275,118,32,-125,18,0,0,6
3473,01/08/2013,3997,4044,3994,4043,-259,320,-23,38,46,0,1,6
3474,02/08/2013,4059,4060,4028,4046,-418,87,-31,-362,-13,1,0,6
3475,05/08/2013,4049,4063,4040,4050,-610,-215,-23,-848,1,0,0,7
3476,06/08/2013,4051,4065,4014,4033,-436,-275,-75,-786,-18,1,0,7
3477,07/08/2013,4025,4044,4011,4038,173,46,323,542,13,0,1,7
3478,08/08/2013,4046,4070,4033,4064,138,372,312,822,18,0,1,7
3479,09/08/2013,4074,4088,4050,4077,-249,0,18,-231,3,0,0,7
3480,12/08/2013,4081,4089,4049,4072,-432,-155,-167,-754,-9,1,0,6
3481,13/08/2013,4082,4092,4075,4092,173,46,323,542,10,0,1,6
3482,14/08/2013,4099,4122,4092,4114,-396,382,-58,-72,15,0,0,7
3483,15/08/2013,4109,4112,4055,4093,-445,-72,-96,-613,-16,1,0,7
3484,16/08/2013,4093,4124,4078,4124,167,346,-137,376,31,0,1,7
3485,19/08/2013,4122,4122,4081,4084,-428,-153,-164,-745,-38,1,0,7
3486,20/08/2013,4067,4068,4005,4029,-515,87,16,-412,-38,1,0,8
3487,21/08/2013,4042,4048,4015,4015,287,327,177,791,-27,0,0,8
3488,22/08/2013,4018,4072,4018,4059,219,140,48,407,41,0,1,7
3489,23/08/2013,4059,4074,4026,4069,-44,-145,-139,-328,10,0,0,7
3490,26/08/2013,4073,4073,4038,4067,94,-44,-44,6,-6,0,0,7
3491,27/08/2013,4049,4062,3969,3969,-30,-113,9,-134,-80,1,0,6
3492,28/08/2013,3955,3976,3935,3960,132,-434,107,-195,5,0,0,6
3493,29/08/2013,3981,3990,3951,3986,-261,-264,-202,-727,5,0,0,6
3494,30/08/2013,3986,3989,3934,3934,-5,53,-61,-13,-52,1,0,5
3495,02/09/2013,3975,4014,3975,4006,215,-153,80,142,31,0,1,5
3496,03/09/2013,4015,4015,3951,3974,159,40,-123,76,-41,0,0,5
3497,04/09/2013,3982,3988,3928,3980,15,164,198,377,-2,0,0,4
3498,05/09/2013,3986,4010,3968,4007,72,-327,45,-210,21,0,0,4
3499,06/09/2013,4001,4049,3986,4049,200,62,-61,201,48,0,1,3
3500,09/09/2013,4046,4048,4023,4040,-33,-211,145,-99,-6,1,0,4
3501,10/09/2013,4071,4120,4067,4117,68,-171,147,44,46,0,1,5
3502,11/09/2013,4107,4123,4101,4119,51,40,9,100,12,0,1,5
3503,12/09/2013,4118,4121,4095,4107,343,-26,14,331,-11,0,0,6
3504,13/09/2013,4102,4117,4096,4114,-77,192,-82,33,12,0,1,6
3505,16/09/2013,4154,4163,4138,4152,-163,-33,-94,-290,-2,1,0,6
3506,17/09/2013,4142,4156,4131,4146,-56,61,111,116,4,0,1,6
3507,18/09/2013,4147,4170,4134,4170,58,-115,-114,-171,23,0,0,7
3508,19/09/2013,4228,4228,4189,4206,-441,-6,-54,-501,-22,1,0,7
3509,20/09/2013,4195,4220,4194,4204,-129,-111,-8,-248,9,0,0,8
3510,23/09/2013,4207,4217,4163,4172,210,-62,-85,63,-35,0,0,7
3511,24/09/2013,4175,4206,4174,4196,-53,-40,-71,-164,21,0,0,6
3512,25/09/2013,4185,4203,4172,4195,85,-152,-188,-255,10,0,0,5
3513,26/09/2013,4199,4202,4171,4187,-351,94,-158,-415,-12,1,0,4
3514,27/09/2013,4193,4201,4164,4187,409,369,-168,610,-6,0,0,5
3515,30/09/2013,4142,4150,4120,4143,-76,-351,-48,-475,1,0,0,4
3516,01/10/2013,4152,4197,4150,4197,145,275,124,544,45,0,1,3
3517,02/10/2013,4178,4181,4137,4158,-158,-354,6,-506,-20,1,0,3
3518,03/10/2013,4159,4167,4125,4128,-75,-59,-76,-210,-31,1,0,4
3519,04/10/2013,4127,4176,4125,4164,172,316,54,542,37,0,1,4
3520,07/10/2013,4145,4166,4106,4166,17,-87,-28,-98,21,0,0,5
3521,08/10/2013,4161,4172,4133,4134,65,-152,-94,-181,-27,1,0,5
3522,09/10/2013,4127,4162,4114,4127,1,-155,-59,-213,0,0,0,6
3523,10/10/2013,4156,4221,4148,4218,-42,244,-59,143,62,0,1,6
3524,11/10/2013,4227,4228,4209,4220,-515,-154,-145,-814,-7,1,0,6
3525,14/10/2013,4206,4223,4193,4223,-563,-95,-102,-760,17,0,0,7
3526,15/10/2013,4239,4262,4232,4256,-498,-116,-17,-631,17,0,0,7
3527,16/10/2013,4231,4248,4213,4244,-271,101,28,-142,13,0,0,6
3528,17/10/2013,4234,4242,4205,4240,-194,-211,28,-377,6,0,0,5
3529,18/10/2013,4260,4286,4247,4286,120,-78,83,125,26,0,1,4
3530,21/10/2013,4286,4286,4268,4277,-337,-133,26,-444,-9,1,0,4
3531,22/10/2013,4266,4309,4263,4295,-192,156,134,98,29,0,1,5
3532,23/10/2013,4272,4275,4250,4261,-515,-17,222,-310,-11,1,0,5
3533,24/10/2013,4272,4281,4260,4276,-337,92,119,-126,4,0,0,6
3534,25/10/2013,4249,4280,4242,4272,-92,196,238,342,23,0,1,5
3535,28/10/2013,4288,4289,4236,4252,-217,8,119,-90,-36,1,0,5
3536,29/10/2013,4242,4281,4242,4278,-188,-25,-208,-421,36,0,0,6
3537,30/10/2013,4273,4310,4265,4274,342,-57,119,404,1,0,1,6
3538,31/10/2013,4261,4304,4255,4300,-50,21,-14,-43,39,0,0,7
3539,01/11/2013,4302,4305,4267,4273,82,-52,-203,-173,-29,1,0,7
3540,04/11/2013,4285,4296,4277,4289,-166,95,5,-66,4,0,0,7
3541,05/11/2013,4297,4297,4233,4253,-102,-161,46,-217,-44,1,0,6
3542,06/11/2013,4265,4300,4265,4287,-71,157,63,149,22,0,1,6
3543,07/11/2013,4283,4356,4269,4281,-49,-404,46,-407,-2,1,0,6
3544,08/11/2013,4254,4268,4212,4260,279,-351,-222,-294,6,0,0,7
3545,11/11/2013,4263,4296,4253,4290,-99,-65,-32,-196,27,0,0,6
3546,12/11/2013,4289,4298,4264,4264,-196,-404,-344,-944,-25,1,0,5
3547,13/11/2013,4251,4266,4213,4240,-45,-101,-78,-224,-11,1,0,6
3548,14/11/2013,4286,4294,4258,4284,-96,-115,-4,-215,-2,1,0,6
3549,15/11/2013,4282,4300,4272,4292,-93,-19,-230,-342,10,0,0,7
3550,18/11/2013,4289,4337,4277,4321,129,-110,-214,-195,32,0,0,6
3551,19/11/2013,4303,4303,4264,4272,-275,-40,38,-277,-31,1,0,6
3552,20/11/2013,4263,4291,4249,4268,-52,-195,60,-187,5,0,0,6
3553,21/11/2013,4247,4266,4222,4254,-109,157,87,135,7,0,1,5
3554,22/11/2013,4265,4285,4251,4279,-71,47,39,15,14,0,1,5
3555,25/11/2013,4298,4308,4291,4302,-86,-118,-106,-310,4,0,0,6
3556,26/11/2013,4296,4305,4278,4278,186,218,59,463,-18,0,0,6
3557,27/11/2013,4287,4304,4277,4293,-143,2,-95,-236,6,0,0,5
3558,28/11/2013,4292,4312,4289,4302,-168,92,-158,-234,10,0,0,4
3559,29/11/2013,4297,4311,4294,4295,-113,174,-25,36,-2,0,0,3
3560,02/12/2013,4295,4309,4273,4286,-83,8,-158,-233,-9,1,0,3
3561,03/12/2013,4276,4277,4172,4172,168,-8,-106,54,-104,0,0,4
3562,04/12/2013,4184,4193,4120,4149,108,-183,152,77,-35,0,0,3
3563,05/12/2013,4141,4157,4100,4100,42,-8,235,269,-41,0,0,3
3564,06/12/2013,4111,4141,4082,4129,316,-197,86,205,18,0,1,2
3565,09/12/2013,4143,4143,4110,4134,-156,18,-278,-416,-9,1,0,2
3566,10/12/2013,4127,4145,4091,4091,47,204,155,406,-36,0,0,3
3567,11/12/2013,4094,4128,4086,4087,152,-364,-2,-214,-7,1,0,3
3568,12/12/2013,4078,4090,4056,4069,-237,-264,-142,-643,-9,1,0,4
3569,13/12/2013,4070,4086,4053,4060,-51,-160,231,20,-10,0,0,5
3570,16/12/2013,4052,4129,4051,4120,-21,-23,-45,-89,68,0,0,5
3571,17/12/2013,4101,4101,4069,4069,316,41,-32,325,-32,0,0,4
3572,18/12/2013,4088,4110,4074,4110,1,188,227,416,22,0,1,4
3573,19/12/2013,4146,4184,4144,4154,237,-16,-188,33,8,0,1,5
3574,20/12/2013,4177,4200,4167,4194,-68,-209,28,-249,17,0,0,6
3575,23/12/2013,4200,4215,4188,4215,-84,131,152,199,15,0,1,5
3576,24/12/2013,4210,4230,4209,4218,-179,-30,-152,-361,8,0,0,5
3577,27/12/2013,4246,4279,4237,4278,314,-290,143,167,32,0,1,5
3578,30/12/2013,4283,4290,4268,4276,-163,-87,-60,-310,-7,1,0,5
3579,31/12/2013,4281,4297,4281,4296,34,-116,-239,-321,15,0,0,5
3580,02/01/2014,4307,4313,4227,4227,-441,-238,-311,-990,-80,1,0,5
3581,03/01/2014,4239,4259,4229,4248,189,169,113,471,9,0,1,6
3582,06/01/2014,4242,4261,4222,4228,-127,316,183,372,-14,0,0,7
3583,07/01/2014,4232,4267,4216,4263,-234,25,-95,-304,31,0,0,6
3584,08/01/2014,4269,4272,4246,4261,45,59,76,180,-8,0,0,5
3585,09/01/2014,4260,4278,4216,4225,342,-224,52,170,-35,0,0,5
3586,10/01/2014,4247,4269,4233,4251,30,87,96,213,4,0,1,4
3587,13/01/2014,4262,4269,4247,4263,-58,142,-53,31,1,0,1,5
3588,14/01/2014,4227,4274,4214,4274,-231,-202,14,-419,47,0,0,5
3589,15/01/2014,4287,4332,4283,4332,-127,368,125,366,45,0,1,4
3590,16/01/2014,4333,4335,4313,4319,-337,-261,-21,-619,-14,1,0,5
3591,17/01/2014,4324,4342,4313,4328,-215,70,-337,-482,4,0,0,5
3592,20/01/2014,4321,4333,4314,4323,122,-95,-303,-276,2,0,0,4
3593,21/01/2014,4327,4351,4317,4324,-1,293,-223,69,-3,0,0,4
3594,22/01/2014,4338,4347,4308,4325,-372,320,80,28,-13,0,0,4
3595,23/01/2014,4319,4339,4267,4281,67,382,-14,435,-38,0,0,4
3596,24/01/2014,4284,4292,4155,4161,34,-221,104,-83,-123,1,0,4
3597,27/01/2014,4166,4172,4138,4145,51,-48,140,143,-21,0,0,4
3598,28/01/2014,4171,4198,4154,4185,-144,-21,30,-135,14,0,0,3
3599,29/01/2014,4221,4246,4107,4157,75,-40,-202,-167,-64,1,0,3
3600,30/01/2014,4160,4196,4124,4180,-31,156,22,147,20,0,1,3
3601,31/01/2014,4195,4195,4099,4166,-185,-150,-201,-536,-29,1,0,3
3602,03/02/2014,4160,4185,4105,4108,-254,80,-227,-401,-52,1,0,4
3603,04/02/2014,4092,4132,4081,4117,-96,-326,-153,-575,25,0,0,5
3604,05/02/2014,4112,4137,4099,4118,-29,353,-148,176,6,0,1,5
3605,06/02/2014,4139,4201,4123,4188,32,-188,-39,-195,49,0,0,6
3606,07/02/2014,4199,4229,4172,4228,136,-73,152,215,29,0,1,6
3607,10/02/2014,4248,4251,4229,4237,-146,-91,-308,-545,-11,1,0,6
3608,11/02/2014,4251,4283,4247,4283,-242,-396,-308,-946,32,0,0,7
3609,12/02/2014,4296,4324,4288,4306,-77,-102,59,-120,10,0,0,7
3610,13/02/2014,4293,4316,4275,4313,95,40,-193,-58,20,0,0,6
3611,14/02/2014,4320,4340,4305,4340,-104,-195,-239,-538,20,0,0,5
3612,17/02/2014,4346,4353,4330,4335,-194,-102,1,-295,-11,1,0,4
3613,18/02/2014,4341,4342,4305,4331,-794,61,95,-638,-10,1,0,4
3614,19/02/2014,4322,4353,4313,4341,-58,-72,98,-32,19,0,0,5
3615,20/02/2014,4298,4357,4290,4355,-445,-58,284,-219,57,0,0,4
3616,21/02/2014,4370,4383,4353,4381,-428,77,-60,-411,11,0,0,4
3617,24/02/2014,4374,4419,4374,4419,-551,51,-47,-547,45,0,0,3
3618,25/02/2014,4406,4416,4383,4415,-325,-83,-41,-449,9,0,0,2
3619,26/02/2014,4414,4421,4381,4397,-174,-170,-167,-511,-17,1,0,2
3620,27/02/2014,4401,4408,4355,4396,33,-105,-42,-114,-5,1,0,3
3621,28/02/2014,4405,4414,4368,4408,111,172,49,332,3,0,1,4
3622,03/03/2014,4339,4347,4288,4291,-313,49,-25,-289,-48,1,0,5
3623,04/03/2014,4341,4400,4337,4396,188,415,264,867,55,0,1,5
3624,05/03/2014,4385,4402,4378,4391,-192,-340,-234,-766,6,0,0,5
3625,06/03/2014,4408,4431,4402,4417,-234,-373,-192,-799,9,0,0,5
3626,07/03/2014,4416,4432,4364,4366,-53,-28,191,110,-50,0,0,5
3627,10/03/2014,4365,4418,4347,4371,-59,-41,-61,-161,6,0,0,5
3628,11/03/2014,4385,4387,4344,4350,67,-136,-79,-148,-35,1,0,5
3629,12/03/2014,4323,4328,4273,4306,-50,-129,-139,-318,-17,1,0,6
3630,13/03/2014,4315,4320,4251,4251,-356,-64,22,-398,-64,1,0,6
3631,14/03/2014,4221,4237,4183,4216,98,-364,-142,-408,-5,1,0,6
3632,17/03/2014,4217,4277,4212,4272,109,-323,52,-162,55,0,0,6
3633,18/03/2014,4264,4342,4250,4313,-111,89,-61,-83,49,0,0,5
3634,19/03/2014,4313,4329,4295,4308,-113,20,52,-41,-5,1,0,4
3635,20/03/2014,4277,4328,4261,4328,101,74,73,248,51,0,1,5
3636,21/03/2014,4333,4353,4323,4335,-214,76,-24,-162,2,0,0,6
3637,24/03/2014,4322,4332,4267,4276,-72,-194,11,-255,-46,1,0,6
3638,25/03/2014,4287,4352,4287,4344,42,47,-157,-68,57,0,0,7
3639,26/03/2014,4358,4398,4354,4385,292,25,132,449,27,0,1,6
3640,27/03/2014,4375,4390,4359,4379,-260,194,47,-19,4,0,0,6
3641,28/03/2014,4392,4411,4388,4411,-94,24,48,-22,19,0,0,5
3642,31/03/2014,4427,4431,4391,4392,28,-50,30,8,-35,0,0,4
3643,01/04/2014,4409,4440,4401,4427,120,38,154,312,18,0,1,4
3644,02/04/2014,4429,4439,4422,4431,-503,-186,-126,-815,2,0,0,5
3645,03/04/2014,4431,4470,4417,4449,-436,-16,49,-403,18,0,0,4
3646,04/04/2014,4460,4497,4447,4485,-587,85,-85,-587,25,0,0,3
3647,07/04/2014,4453,4464,4432,4436,-106,-20,-8,-134,-17,1,0,3
3648,08/04/2014,4443,4448,4385,4425,111,-51,-64,-4,-18,1,0,3
3649,09/04/2014,4431,4455,4426,4443,236,89,-203,122,12,0,1,4
3650,10/04/2014,4457,4466,4409,4413,124,-3,-151,-30,-44,1,0,4
3651,11/04/2014,4379,4384,4334,4366,16,44,90,150,-13,0,0,5
3652,14/04/2014,4346,4385,4319,4385,-183,44,36,-103,39,0,0,5
3653,15/04/2014,4380,4404,4344,4345,49,336,126,511,-35,0,0,5
3654,16/04/2014,4389,4406,4375,4406,103,-374,-94,-365,17,0,0,4
3655,17/04/2014,4412,4433,4392,4432,-44,277,-137,96,20,0,1,4
3656,22/04/2014,4452,4488,4444,4484,-70,87,238,255,32,0,1,5
3657,23/04/2014,4480,4481,4449,4451,-6,14,-57,-49,-29,1,0,6
3658,24/04/2014,4474,4499,4441,4480,30,318,104,452,6,0,1,6
3659,25/04/2014,4459,4473,4431,4444,-123,-275,-72,-470,-15,1,0,6
3660,28/04/2014,4455,4478,4444,4461,201,-372,-83,-254,6,0,0,6
3661,29/04/2014,4464,4504,4450,4498,86,219,-210,95,34,0,1,5
3662,30/04/2014,4474,4491,4471,4487,-551,57,-72,-566,13,0,0,6
3663,02/05/2014,4474,4485,4447,4458,280,-56,-92,132,-16,0,0,6
3664,05/05/2014,4454,4467,4401,4463,-81,140,-139,-80,9,0,0,6
3665,06/05/2014,4475,4477,4420,4428,-213,-196,-143,-552,-47,1,0,6
3666,07/05/2014,4414,4453,4402,4446,-326,4,-31,-353,32,0,0,6
3667,08/05/2014,4457,4507,4440,4507,-234,34,-9,-209,50,0,0,5
3668,09/05/2014,4492,4496,4465,4477,-334,-317,-64,-715,-15,1,0,4
3669,12/05/2014,4466,4463,4495,4493,-283,-224,-97,-604,27,0,0,4
3670,13/05/2014,4504,4511,4492,4505,-53,-40,-71,-164,1,0,0,3
3671,14/05/2014,4506,4506,4489,4501,288,157,-158,287,-5,0,0,3
3672,15/05/2014,4498,4512,4440,4444,-290,172,-167,-285,-54,1,0,2
3673,16/05/2014,4447,4456,4419,4456,-243,157,-112,-198,9,0,0,3
3674,19/05/2014,4448,4476,4418,4470,-97,-114,-26,-237,22,0,0,3
3675,20/05/2014,4459,4473,4445,4452,-158,-92,-159,-409,-7,1,0,3
3676,21/05/2014,4436,4473,4424,4469,181,-42,47,186,33,0,1,3
3677,22/05/2014,4474,4481,4451,4478,-14,-192,53,-153,4,0,0,4
3678,23/05/2014,4480,4496,4469,4493,125,-45,34,114,13,0,1,4
3679,26/05/2014,4504,4527,4496,4527,55,-171,9,-107,23,0,0,4
3680,27/05/2014,4515,4536,4511,4529,-432,-225,117,-540,14,0,0,4
3681,28/05/2014,4527,4536,4517,4531,-432,142,-48,-338,4,0,0,4
3682,29/05/2014,4524,4533,4515,4530,-347,22,142,-183,6,0,0,4
3683,30/05/2014,4510,4524,4495,4519,132,-112,87,107,9,0,1,3
3684,02/06/2014,4523,4529,4502,4515,-177,120,-152,-209,-8,1,0,4
3685,03/06/2014,4513,4516,4499,4503,-296,311,93,108,-10,0,0,5
3686,04/06/2014,4496,4508,4470,4501,15,-152,-92,-229,5,0,0,4
3687,05/06/2014,4504,4576,4487,4548,-194,113,-69,-150,44,0,0,3
3688,06/06/2014,4553,4586,4539,4581,64,-252,8,-180,28,0,0,3
