,Date,Open,High,Low,Close,a1,a2,a3,a4,pl,,,
2000,08/11/2007,7772,7844,7702,7819,-625,57,51,-517,47,0,,
2001,09/11/2007,7830,7919,7793,7812,68,-145,-197,-274,-18,1,0,
2002,12/11/2007,7780,7811,7766,7807,-635,53,-29,-611,27,0,0,
2003,13/11/2007,7781,7792,7752,7778,-71,-146,52,-165,-3,1,0,
2004,14/11/2007,7821,7866,7766,7783,-214,-601,-15,-830,-38,1,0,
2005,15/11/2007,7782,7804,7636,7667,38,148,-201,-15,-115,1,0,
2006,16/11/2007,7636,7656,7565,7612,-488,-458,-76,-1022,-24,1,0,
2007,19/11/2007,7608,7623,7499,7512,-72,-466,-120,-658,-96,1,0,
2008,20/11/2007,7550,7634,7524,7630,-13,384,41,412,80,0,1,
2009,21/11/2007,7570,7570,7475,7518,126,76,-8,194,-52,0,0,
2010,22/11/2007,7539,7581,7488,7562,124,23,23,170,23,0,1,
2011,23/11/2007,7565,7620,7549,7609,-15,123,86,194,44,0,1,
2012,26/11/2007,7642,7675,7560,7567,-354,-241,-181,-776,-75,1,0,8
2013,27/11/2007,7538,7546,7445,7531,-43,-616,-99,-758,-7,1,0,9
2014,28/11/2007,7552,7729,7537,7724,247,55,247,549,172,0,1,9
2015,29/11/2007,7755,7780,7729,7765,158,45,-140,63,10,0,1,9
2016,30/11/2007,7772,7894,7772,7871,214,-4,99,309,99,0,1,9
2017,03/12/2007,7859,7890,7826,7837,42,-54,-54,-66,-22,1,0,9
2018,04/12/2007,7842,7850,7785,7809,120,64,45,229,-33,0,0,9
2019,05/12/2007,7851,7954,7843,7945,-151,69,24,-58,94,0,0,8
2020,06/12/2007,7958,7998,7911,7941,247,114,131,492,-17,0,0,8
2021,07/12/2007,7963,8010,7958,7994,95,-18,31,108,31,0,1,7
2022,10/12/2007,7973,8058,7955,8033,38,-197,-45,-204,60,0,0,7
2023,11/12/2007,8050,8067,7983,8009,118,-141,-120,-143,-41,1,0,6
2024,12/12/2007,7969,8118,7928,8076,-84,228,225,369,107,0,1,6
2025,13/12/2007,8014,8034,7923,7928,-210,-35,-61,-306,-86,1,0,6
2026,14/12/2007,7949,7987,7873,7948,7,71,70,148,-1,0,0,6
2027,17/12/2007,7884,7884,7812,7825,207,-245,-175,-213,-59,1,0,5
2028,18/12/2007,7811,7943,7796,7851,-30,142,40,152,40,0,1,5
2029,19/12/2007,7865,7877,7777,7837,-53,511,-1,457,-28,0,0,6
2030,20/12/2007,7842,7919,7842,7869,105,702,190,997,27,0,1,6
2031,21/12/2007,7913,8015,7913,8003,86,82,-7,161,90,0,1,7
2032,27/12/2007,8039,8074,8025,8039,-143,-256,-7,-406,0,0,0,7
2033,28/12/2007,8011,8069,7992,8067,67,-380,53,-260,56,0,0,7
2034,02/01/2008,8046,8101,7925,7949,-97,-296,-84,-477,-97,1,0,6
2035,03/01/2008,7942,7970,7858,7908,-122,-176,143,-155,-34,1,0,6
2036,04/01/2008,7914,7915,7780,7809,22,-517,29,-466,-105,1,0,6
2037,07/01/2008,7811,7859,7782,7817,-265,-40,67,-238,6,0,0,7
2038,08/01/2008,7844,7923,7832,7850,60,46,174,280,6,0,1,6
2039,09/01/2008,7839,7842,7770,7783,89,-606,100,-417,-56,1,0,6
2040,10/01/2008,7799,7831,7701,7713,-15,-608,-106,-729,-86,1,0,7
2041,11/01/2008,7717,7746,7675,7718,-383,-817,-335,-1535,1,0,0,7
2042,14/01/2008,7693,7759,7684,7732,310,-284,-15,11,39,0,1,6
2043,15/01/2008,7715,7724,7564,7566,-625,-581,-432,-1638,-149,1,0,7
2044,16/01/2008,7536,7556,7450,7472,-154,-272,-70,-496,-64,1,0,8
2045,17/01/2008,7505,7547,7400,7414,-199,-132,-199,-530,-91,1,0,8
2046,18/01/2008,7418,7501,7287,7314,48,293,-129,212,-104,0,0,8
2047,21/01/2008,7293,7293,6763,6790,-503,-231,-503,-1237,-503,1,0,7
2048,22/01/2008,6591,6878,6421,6769,178,178,178,534,178,0,1,8
2049,23/01/2008,6812,6885,6384,6439,-373,-250,-373,-996,-373,1,0,8
2050,24/01/2008,6550,6855,6550,6821,271,691,271,1233,271,0,1,8
2051,25/01/2008,6884,7002,6782,6817,-67,-67,-67,-201,-67,1,0,8
2052,28/01/2008,6749,6827,6680,6819,70,70,39,179,70,0,1,9
2053,29/01/2008,6835,6930,6824,6893,108,73,66,247,58,0,1,9
2054,30/01/2008,6887,6921,6822,6875,-146,164,-13,5,-12,0,0,9
2055,31/01/2008,6857,6888,6691,6852,-225,-209,38,-396,-5,1,0,8
2056,01/02/2008,6896,7037,6896,6969,339,147,265,751,73,0,1,8
2057,04/02/2008,7019,7059,6976,7000,44,-122,-6,-84,-19,1,0,9
2058,05/02/2008,6999,7000,6744,6765,-67,-420,-274,-761,-234,1,0,9
2059,06/02/2008,6727,6862,6697,6848,-250,119,-165,-296,121,0,0,9
2060,07/02/2008,6829,6839,6656,6734,-225,21,1,-203,-95,1,0,8
2061,08/02/2008,6778,6852,6706,6767,-207,-11,74,-144,-11,1,0,8
2062,11/02/2008,6724,6812,6691,6744,176,174,-50,300,20,0,1,8
2063,12/02/2008,6793,6979,6746,6968,139,-41,158,256,175,0,1,8
2064,13/02/2008,6914,7007,6870,6974,-12,104,46,138,60,0,1,8
2065,14/02/2008,7025,7062,6935,6962,-111,63,-73,-121,-63,1,0,9
2066,15/02/2008,6967,7013,6798,6832,-96,-132,-9,-237,-135,1,0,9
2067,19/02/2008,6948,7080,6891,7002,-71,-101,-41,-213,54,0,0,9
2068,20/02/2008,6933,6965,6853,6900,73,-1,-143,-71,-33,1,0,8
2069,21/02/2008,6928,7018,6881,6905,-354,254,-419,-519,-23,1,0,8
2070,22/02/2008,6889,6889,6763,6806,-106,110,-419,-415,-83,1,0,9
2071,25/02/2008,6851,6923,6825,6883,365,-20,205,550,32,0,1,9
2072,26/02/2008,6906,7007,6906,6986,174,55,218,447,80,0,1,9
2073,27/02/2008,7008,7018,6881,6998,-78,7,127,56,-10,0,0,9
2074,28/02/2008,6985,6995,6850,6863,-45,-426,146,-325,-122,1,0,8
2075,29/02/2008,6848,6865,6699,6748,-105,-94,48,-151,-100,1,0,8
2076,03/03/2008,6693,6702,6609,6690,-1,-3,24,20,-3,0,0,8
2077,04/03/2008,6693,6720,6517,6545,-13,-459,-147,-619,-148,1,0,7
2078,05/03/2008,6583,6699,6579,6684,101,383,101,585,101,0,1,8
2079,06/03/2008,6675,6683,6570,6591,-488,-166,-195,-849,-84,1,0,8
2080,07/03/2008,6551,6562,6451,6514,8,-37,-231,-260,-37,1,0,8
2081,10/03/2008,6487,6537,6415,6448,-83,133,-29,21,-39,0,0,8
2082,11/03/2008,6463,6604,6432,6525,205,-489,71,-213,62,0,0,7
2083,12/03/2008,6575,6667,6569,6599,24,-475,175,-276,24,0,0,6
2084,13/03/2008,6530,6530,6399,6501,-143,-134,-13,-290,-29,1,0,6
2085,14/03/2008,6500,6623,6392,6452,10,-122,273,161,-48,0,0,6
2086,17/03/2008,6361,6362,6168,6182,-625,-206,-60,-891,-179,1,0,5
2087,18/03/2008,6238,6418,6238,6393,307,-231,215,291,155,0,1,6
2088,19/03/2008,6429,6470,6311,6361,162,157,-172,147,-68,0,0,6
2089,20/03/2008,6331,6376,6271,6320,100,-602,-89,-591,-11,1,0,5
2090,25/03/2008,6443,6540,6443,6525,82,-19,183,246,82,0,1,5
2091,26/03/2008,6508,6538,6469,6489,-374,62,22,-290,-19,1,0,5
2092,27/03/2008,6486,6610,6479,6578,-257,-547,-33,-837,92,0,0,6
2093,28/03/2008,6587,6616,6535,6560,147,-182,-17,-52,-27,1,0,6
2094,31/03/2008,6530,6541,6430,6535,112,-49,63,126,5,0,1,7
2095,01/04/2008,6519,6734,6497,6720,-106,6,50,-50,201,0,0,7
2096,02/04/2008,6749,6807,6726,6777,-67,28,13,-26,28,0,0,7
2097,03/04/2008,6788,6803,6696,6742,-450,-46,-46,-542,-46,1,0,6
2098,04/04/2008,6754,6797,6691,6763,95,-49,23,69,9,0,1,6
2099,07/04/2008,6803,6843,6795,6821,-73,121,-115,-67,18,0,0,7
2100,08/04/2008,6795,6795,6724,6772,533,75,50,658,-23,0,0,6
2101,09/04/2008,6751,6785,6705,6721,-247,-68,44,-271,-30,1,0,5
2102,10/04/2008,6717,6719,6609,6704,-217,88,384,255,-13,0,0,5
2103,11/04/2008,6739,6768,6571,6604,210,-246,358,322,-135,0,0,5
2104,14/04/2008,6562,6573,6517,6554,-3,-42,246,201,-8,0,0,4
2105,15/04/2008,6581,6627,6525,6585,-278,4,-88,-362,4,0,0,3
2106,16/04/2008,6625,6711,6601,6703,208,-198,381,391,78,0,1,3
2107,17/04/2008,6717,6743,6665,6682,-8,-63,94,23,-35,0,0,4
2108,18/04/2008,6703,6860,6703,6843,-231,251,25,45,140,0,1,3
2109,21/04/2008,6841,6849,6750,6787,159,-134,-159,-134,-54,1,0,3
2110,22/04/2008,6762,6819,6703,6728,-467,454,-152,-165,-34,1,0,4
2111,23/04/2008,6740,6814,6657,6795,131,92,137,360,55,0,1,5
2112,24/04/2008,6777,6828,6721,6821,-135,155,44,64,44,0,1,5
2113,25/04/2008,6856,6945,6849,6897,7,82,71,160,41,0,1,6
2114,28/04/2008,6914,6966,6820,6925,150,57,-71,136,11,0,1,7
2115,29/04/2008,6905,6910,6855,6885,-210,-5,82,-133,-20,1,0,8
2116,30/04/2008,6888,6963,6852,6949,224,23,103,350,61,0,1,9
2117,02/05/2008,6982,7093,6972,7043,573,252,121,946,61,0,1,9
2118,05/05/2008,7037,7060,7022,7052,419,85,20,524,15,0,1,10
2119,06/05/2008,7044,7062,6969,7017,393,-33,-52,308,-27,0,0,10
2120,07/05/2008,7041,7108,7037,7076,-49,22,21,-6,35,0,0,9
2121,08/05/2008,7038,7073,7013,7072,612,264,136,1012,34,0,1,8
2122,09/05/2008,7041,7041,6962,7003,-58,-135,29,-164,-38,1,0,8
2123,12/05/2008,7021,7065,7006,7036,-30,282,22,274,15,0,1,8
2124,13/05/2008,7063,7081,7002,7060,122,206,-89,239,-3,0,0,8
2125,14/05/2008,7082,7101,7001,7083,-402,-101,-181,-684,1,0,0,7
2126,15/05/2008,7072,7089,7037,7081,-157,-360,-14,-531,9,0,0,6
2127,16/05/2008,7104,7206,7104,7157,-430,315,-285,-400,53,0,0,5
2128,19/05/2008,7177,7232,7165,7226,-174,312,-5,133,49,0,1,4
2129,20/05/2008,7188,7189,7108,7118,-101,45,-68,-124,-70,1,0,4
2130,21/05/2008,7129,7151,7013,7041,-354,254,-419,-519,-88,1,0,5
2131,22/05/2008,7016,7090,6981,7070,-71,-146,-97,-314,54,0,0,6
2132,23/05/2008,7058,7066,6935,6944,15,-802,116,-671,-114,1,0,5
2133,26/05/2008,6924,6965,6918,6954,204,-80,70,194,30,0,1,5
2134,27/05/2008,6966,7006,6906,6959,336,47,381,764,-7,0,0,5
2135,28/05/2008,6981,7082,6955,7034,629,511,309,1449,53,0,1,5
2136,29/05/2008,7056,7085,7005,7055,-130,-708,-253,-1091,-1,1,0,6
2137,30/05/2008,7066,7125,7064,7097,-92,-131,-54,-277,31,0,0,7
2138,02/06/2008,7099,7102,6995,7009,-84,-655,-33,-772,-90,1,0,7
2139,03/06/2008,6987,7023,6962,7019,155,97,-98,154,32,0,1,7
2140,04/06/2008,6994,6994,6898,6965,-191,-59,-54,-304,-29,1,0,7
2141,05/06/2008,6965,7009,6905,6942,-133,-246,-42,-421,-23,1,0,7
2142,06/06/2008,6966,7003,6796,6804,-319,-441,-67,-827,-162,1,0,8
2143,09/06/2008,6790,6839,6763,6816,-63,-260,73,-250,26,0,0,8
2144,10/06/2008,6789,6799,6716,6771,-183,378,-149,46,-18,0,0,7
2145,11/06/2008,6782,6813,6638,6650,-179,-260,-131,-570,-132,1,0,7
2146,12/06/2008,6648,6733,6648,6715,67,95,67,229,67,0,1,7
2147,13/06/2008,6702,6778,6650,6765,117,200,106,423,63,0,1,7
2148,16/06/2008,6773,6813,6672,6730,126,-372,50,-196,-43,1,0,8
2149,17/06/2008,6744,6856,6743,6796,25,64,359,448,52,0,1,8
2150,18/06/2008,6795,6797,6706,6729,-218,-175,-116,-509,-66,1,0,8
2151,19/06/2008,6704,6765,6662,6721,-68,-85,185,32,17,0,1,8
2152,20/06/2008,6731,6766,6547,6578,-293,-461,132,-622,-153,1,0,8
2153,23/06/2008,6587,6629,6573,6589,-183,-209,-391,-783,2,0,0,8
2154,24/06/2008,6588,6617,6444,6536,78,-392,-404,-718,-52,1,0,8
2155,25/06/2008,6552,6629,6548,6618,326,185,132,643,66,0,1,9
2156,26/06/2008,6572,6578,6448,6460,-33,141,200,308,-112,0,0,9
2157,27/06/2008,6449,6465,6348,6422,-134,-249,-134,-517,-27,1,0,8
2158,30/06/2008,6423,6447,6308,6418,221,-79,221,363,-5,0,0,8
2159,01/07/2008,6394,6405,6260,6316,234,221,28,483,-78,0,0,7
2160,02/07/2008,6320,6396,6295,6305,73,123,76,272,-15,0,0,6
2161,03/07/2008,6263,6392,6201,6354,-41,-367,118,-290,91,0,0,5
2162,04/07/2008,6361,6375,6255,6272,395,-270,123,248,-89,0,0,4
2163,07/07/2008,6312,6416,6287,6396,503,-63,-16,424,84,0,1,3
2164,08/07/2008,6314,6332,6227,6304,-398,-150,-49,-597,-10,1,0,4
2165,09/07/2008,6331,6398,6331,6386,-150,-184,216,-118,55,0,0,4
2166,10/07/2008,6339,6385,6254,6305,58,293,-104,247,-34,0,0,3
2167,11/07/2008,6310,6332,6140,6153,-509,-477,-136,-1122,-157,1,0,3
2168,14/07/2008,6185,6254,6185,6200,117,189,-44,262,15,0,1,3
2169,15/07/2008,6155,6165,6007,6082,153,-84,63,132,-73,0,0,4
2170,16/07/2008,6101,6177,5999,6155,88,-268,88,-92,54,0,0,4
2171,17/07/2008,6177,6318,6177,6271,395,-270,123,248,94,0,1,4
2172,18/07/2008,6261,6396,6237,6383,171,933,243,1347,122,0,1,5
2173,21/07/2008,6381,6484,6343,6425,-181,93,65,-23,44,0,0,6
2174,22/07/2008,6395,6450,6322,6443,-20,67,104,151,48,0,1,5
2175,23/07/2008,6486,6562,6485,6536,25,45,104,174,50,0,1,5
2176,24/07/2008,6546,6577,6415,6441,-139,-107,-105,-351,-105,1,0,6
2177,25/07/2008,6412,6480,6331,6437,-145,45,-119,-219,25,0,0,7
2178,28/07/2008,6428,6428,6342,6351,-176,-87,-164,-427,-77,1,0,6
2179,29/07/2008,6303,6425,6265,6399,222,-53,-112,57,96,0,1,6
2180,30/07/2008,6406,6505,6396,6460,-197,69,13,-115,54,0,0,7
2181,31/07/2008,6468,6540,6428,6480,-182,-225,94,-313,12,0,0,7
2182,01/08/2008,6461,6490,6379,6396,-52,-13,4,-61,-65,1,0,6
2183,04/08/2008,6403,6404,6322,6350,-22,105,-167,-84,-53,1,0,6
2184,05/08/2008,6356,6532,6343,6519,-120,130,314,324,163,0,1,7
2185,06/08/2008,6532,6569,6496,6561,192,-298,-76,-182,29,0,0,7
2186,07/08/2008,6543,6621,6521,6543,648,315,304,1267,0,0,0,6
2187,08/08/2008,6538,6586,6443,6562,-319,32,72,-215,24,0,0,5
2188,11/08/2008,6571,6613,6555,6610,-397,-171,-130,-698,39,0,0,5
2189,12/08/2008,6602,6627,6545,6586,648,-48,-214,386,-16,0,0,4
2190,13/08/2008,6563,6567,6417,6422,218,447,113,778,-141,0,0,3
2191,14/08/2008,6451,6481,6370,6442,-63,52,-114,-125,-9,1,0,3
2192,15/08/2008,6460,6514,6394,6446,-13,87,147,221,-14,0,0,4
2193,18/08/2008,6436,6486,6375,6433,89,119,-48,160,-3,0,0,3
2194,19/08/2008,6399,6401,6269,6282,329,-20,-112,197,-117,0,0,2
2195,20/08/2008,6298,6337,6262,6318,3,-37,-500,-534,20,0,0,1
2196,21/08/2008,6290,6293,6219,6237,-64,-284,135,-213,-53,1,0,1
2197,22/08/2008,6244,6356,6229,6342,54,-78,174,150,98,0,1,2
2198,25/08/2008,6333,6362,6289,6297,-161,-300,197,-264,-36,1,0,3
2199,26/08/2008,6288,6371,6238,6341,173,-371,130,-68,53,0,0,4
2200,27/08/2008,6336,6347,6252,6321,334,122,123,579,-15,0,0,4
2201,28/08/2008,6314,6456,6265,6421,-11,346,234,569,107,0,1,4
2202,29/08/2008,6428,6458,6401,6422,19,-81,-96,-158,-6,1,0,4
2203,01/09/2008,6401,6449,6341,6422,-87,-119,-32,-238,21,0,0,5
2204,02/09/2008,6417,6554,6379,6518,109,137,-69,177,101,0,1,5
2205,03/09/2008,6488,6519,6440,6467,12,50,-137,-75,-21,1,0,6
2206,04/09/2008,6477,6482,6263,6280,-193,-201,-55,-449,-197,1,0,7
2207,05/09/2008,6248,6253,6096,6127,-625,-270,-118,-1013,-121,1,0,7
2208,08/09/2008,6262,6357,6241,6264,-128,91,-88,-125,2,0,0,7
2209,09/09/2008,6258,6327,6199,6233,244,52,-113,183,-25,0,0,6
2210,10/09/2008,6225,6254,6161,6210,-380,-412,34,-758,-15,1,0,6
2211,11/09/2008,6193,6202,6086,6179,58,-322,5,-259,-14,1,0,7
2212,12/09/2008,6207,6256,6160,6235,44,57,-31,70,28,0,1,7
2213,15/09/2008,6138,6138,5942,6064,-49,-616,-39,-704,-74,1,0,7
2214,16/09/2008,6017,6024,5859,5965,63,-268,-147,-352,-52,1,0,8
2215,17/09/2008,5978,6036,5825,5861,-219,134,-408,-493,-117,1,0,8
2216,18/09/2008,5875,5967,5813,5863,-12,240,-12,216,-12,0,0,8
2217,19/09/2008,5987,6214,5982,6143,156,29,62,247,156,0,1,7
2218,22/09/2008,6189,6235,6106,6108,-105,-38,-248,-391,-81,1,0,7
2219,23/09/2008,6092,6123,6034,6069,117,270,-137,250,-23,0,0,8
2220,24/09/2008,6071,6109,6014,6053,3,-131,71,-57,-18,1,0,8
2221,25/09/2008,6058,6188,6050,6173,127,232,71,430,115,0,1,8
2222,26/09/2008,6118,6118,6001,6064,-99,-182,-67,-348,-54,1,0,8
2223,29/09/2008,6010,6016,5803,5807,-265,-162,-546,-973,-203,1,0,8
2224,30/09/2008,5728,5837,5658,5831,160,98,581,839,103,0,1,8
2225,01/10/2008,5865,5866,5747,5806,428,234,103,765,-59,0,0,8
2226,02/10/2008,5794,5877,5630,5661,-36,-265,123,-178,-133,1,0,7
2227,03/10/2008,5682,5832,5618,5797,115,333,115,563,115,0,1,8
2228,06/10/2008,5606,5606,5293,5387,-218,-399,-21,-638,-219,1,0,8
2229,07/10/2008,5450,5502,5300,5327,-393,-24,-123,-540,-123,1,0,8
2230,08/10/2008,5237,5319,4870,5014,-223,-331,-223,-777,-223,1,0,9
2231,09/10/2008,5055,5154,4804,4887,-168,-219,-168,-555,-168,1,0,9
2232,10/10/2008,4595,4654,4308,4544,-51,-219,-51,-321,-51,1,0,9
2233,13/10/2008,4642,5062,4641,5062,420,739,420,1579,420,0,1,9
2234,14/10/2008,5135,5384,5095,5199,68,85,64,217,64,0,1,9
2235,15/10/2008,5187,5192,4791,4862,-357,-689,-433,-1479,-325,1,0,9
2236,16/10/2008,4676,4891,4522,4623,-53,-53,-53,-159,-53,1,0,10
2237,17/10/2008,4758,4836,4577,4781,23,23,23,69,23,0,1,10
2238,20/10/2008,4892,4941,4754,4835,-422,-57,139,-340,-57,1,0,10
2239,21/10/2008,4883,4910,4736,4784,10,84,-857,-763,-99,1,0,10
2240,22/10/2008,4740,4740,4536,4571,-301,-239,-787,-1327,-169,1,0,10
2241,23/10/2008,4560,4577,4364,4520,-38,-40,116,38,-40,0,0,10
2242,24/10/2008,4363,4363,4015,4296,-19,-486,-19,-524,-67,1,0,9
2243,27/10/2008,4143,4486,4063,4335,192,382,192,766,192,0,1,9
2244,28/10/2008,4315,4823,4315,4823,538,414,399,1351,508,0,1,9
2245,29/10/2008,4460,4886,4460,4809,240,349,349,938,349,0,1,9
2246,30/10/2008,4894,5042,4827,4869,421,-72,-25,324,-25,0,0,9
2247,31/10/2008,4856,5067,4785,4988,74,12,282,368,132,0,1,8
2248,03/11/2008,5054,5090,4968,5027,-32,-27,-27,-86,-27,1,0,8
2249,04/11/2008,5019,5303,4993,5278,367,242,259,868,259,0,1,8
2250,05/11/2008,5269,5272,5143,5167,-102,-102,-102,-306,-102,1,0,8
2251,06/11/2008,5102,5102,4782,4814,-288,-288,-323,-899,-288,1,0,8
2252,07/11/2008,4828,5018,4751,4938,46,96,153,295,110,0,1,9
2253,10/11/2008,5024,5135,4998,5026,220,-283,461,398,2,0,1,9
2254,11/11/2008,4984,4984,4742,4762,-157,-247,-175,-579,-222,1,0,9
2255,12/11/2008,4802,4876,4555,4621,-146,-352,-477,-975,-181,1,0,9
2256,13/11/2008,4600,4714,4525,4650,44,142,50,236,50,0,1,9
2257,14/11/2008,4723,4874,4696,4710,3,-13,-13,-23,-13,1,0,10
2258,17/11/2008,4700,4734,4512,4557,-45,-143,-213,-401,-143,1,0,10
2259,18/11/2008,4556,4608,4446,4579,144,23,23,190,23,0,1,10
2260,19/11/2008,4586,4587,4338,4354,-161,-232,-520,-913,-232,1,0,10
2261,20/11/2008,4275,4313,4113,4220,-55,-55,-55,-165,-55,1,0,10
2262,21/11/2008,4228,4297,4035,4127,-101,-188,-101,-390,-101,1,0,10
2263,24/11/2008,4168,4579,4155,4554,386,121,343,850,386,0,1,10
2264,25/11/2008,4522,4693,4455,4560,3,21,231,255,38,0,1,10
2265,26/11/2008,4529,4612,4424,4560,1,105,40,146,31,0,1,10
2266,27/11/2008,4596,4683,4589,4665,183,406,182,771,69,0,1,10
2267,28/11/2008,4666,4704,4567,4669,23,112,-144,-9,3,0,0,10
2268,01/12/2008,4653,4668,4368,4395,-218,-158,-277,-653,-258,1,0,9
2269,02/12/2008,4349,4572,4304,4532,68,256,255,579,183,0,1,9
2270,03/12/2008,4509,4603,4378,4567,27,22,120,169,58,0,1,9
2271,04/12/2008,4560,4733,4492,4564,173,213,-86,300,4,0,1,9
2272,05/12/2008,4529,4531,4322,4381,-290,-272,-373,-935,-148,1,0,9
2273,08/12/2008,4549,4776,4549,4716,353,167,249,769,167,0,1,9
2274,09/12/2008,4674,4850,4622,4779,590,232,204,1026,105,0,1,9
2275,10/12/2008,4810,4839,4743,4805,38,-5,-245,-212,-5,1,0,9
2276,11/12/2008,4792,4822,4710,4767,77,-198,-198,-319,-25,1,0,9
2277,12/12/2008,4660,4699,4522,4663,-85,-91,14,-162,3,0,0,9
2278,15/12/2008,4718,4773,4627,4655,59,-20,43,82,-63,0,0,9
2279,16/12/2008,4663,4758,4656,4730,178,249,-162,265,67,0,1,8
2280,17/12/2008,4769,4784,4639,4708,-91,129,-366,-328,-61,1,0,8
2281,18/12/2008,4730,4785,4716,4756,4,16,138,158,26,0,1,8
2282,19/12/2008,4721,4785,4647,4697,50,232,-142,140,-24,0,0,8
2283,22/12/2008,4694,4701,4576,4639,-190,-111,-277,-578,-55,1,0,7
2284,23/12/2008,4633,4719,4623,4629,45,12,61,118,-4,0,0,7
2285,24/12/2008,4629,4629,4629,4629,-231,33,-116,-314,0,0,0,6
2286,26/12/2008,4629,4629,4629,4629,23,208,-87,144,0,0,0,5
2287,29/12/2008,4660,4733,4656,4705,-144,-29,11,-162,45,0,0,4
2288,30/12/2008,4754,4810,4754,4810,301,11,102,414,56,0,1,4
2289,02/01/2009,4857,4975,4838,4973,512,204,192,908,116,0,1,5
2290,05/01/2009,5010,5035,4949,4984,-396,-26,-26,-448,-26,1,0,5
2291,06/01/2009,4993,5111,4960,5026,24,-103,-103,-182,33,0,0,5
2292,07/01/2009,5009,5011,4914,4937,-397,-56,-56,-509,-72,1,0,4
2293,08/01/2009,4897,4918,4820,4880,-62,175,-172,-59,-17,1,0,5
2294,09/01/2009,4892,4933,4744,4784,-226,-92,258,-60,-108,1,0,5
2295,12/01/2009,4765,4792,4708,4720,39,-246,-48,-255,-45,1,0,6
2296,13/01/2009,4705,4705,4596,4637,386,-68,-68,250,-68,0,0,7
2297,14/01/2009,4662,4671,4380,4422,-233,-292,-240,-765,-240,1,0,7
2298,15/01/2009,4434,4451,4296,4337,-97,-27,-97,-221,-97,1,0,8
2299,16/01/2009,4396,4475,4358,4366,-30,121,-30,61,-30,0,0,8
2300,19/01/2009,4410,4453,4250,4316,-94,414,-94,226,-94,0,0,7
2301,20/01/2009,4297,4382,4223,4240,-57,-237,-57,-351,-57,1,0,6
2302,21/01/2009,4208,4314,4140,4261,53,-231,53,-125,53,0,0,7
2303,22/01/2009,4313,4368,4197,4219,-94,29,-408,-473,-94,1,0,6
2304,23/01/2009,4204,4222,4067,4179,-10,-118,191,63,-25,0,0,6
2305,26/01/2009,4166,4372,4145,4327,131,-367,132,-104,161,0,0,5
2306,27/01/2009,4323,4361,4265,4323,143,-39,-62,42,0,0,0,4
2307,28/01/2009,4348,4534,4348,4519,219,747,-104,862,171,0,1,4
2308,29/01/2009,4496,4501,4394,4428,-73,-78,-54,-205,-68,1,0,4
2309,30/01/2009,4420,4454,4312,4338,-529,-137,106,-560,-82,1,0,4
2310,02/02/2009,4309,4309,4198,4271,-265,81,-104,-288,-38,1,0,5
2311,03/02/2009,4303,4385,4225,4375,57,1,-181,-123,72,0,0,6
2312,04/02/2009,4388,4546,4372,4493,67,-62,-33,-28,105,0,0,5
2313,05/02/2009,4444,4519,4388,4510,525,-15,-37,473,66,0,1,5
2314,06/02/2009,4525,4657,4506,4645,465,180,343,988,120,0,1,5
2315,09/02/2009,4628,4689,4597,4667,55,65,60,180,39,0,1,6
2316,10/02/2009,4637,4649,4506,4506,-15,-58,-305,-378,-131,1,0,7
2317,11/02/2009,4492,4539,4466,4530,-449,64,6,-379,38,0,0,8
2318,12/02/2009,4519,4519,4371,4408,-307,-294,-56,-657,-111,1,0,7
2319,13/02/2009,4459,4509,4398,4413,100,37,-68,69,-46,0,0,7
2320,17/02/2009,4329,4330,4195,4217,-254,-237,-7,-498,-112,1,0,6
2321,18/02/2009,4230,4255,4124,4205,-65,-25,-23,-113,-25,1,0,6
2322,19/02/2009,4213,4275,4189,4215,150,2,-23,129,2,0,1,7
2323,20/02/2009,4165,4167,4015,4015,-36,-105,-150,-291,-150,1,0,8
2324,23/02/2009,4057,4112,3913,3936,-121,154,-121,-88,-121,1,0,8
2325,24/02/2009,3922,3933,3817,3896,-31,31,-31,-31,-26,1,0,8
2326,25/02/2009,3938,3978,3791,3846,-92,43,-92,-141,-92,1,0,8
2327,26/02/2009,3883,3990,3850,3943,60,-231,60,-111,60,0,0,8
2328,27/02/2009,3908,3908,3765,3844,17,234,75,326,-64,0,0,8
2329,02/03/2009,3818,3822,3693,3710,-91,-167,18,-240,-108,1,0,7
2330,03/03/2009,3725,3756,3668,3691,109,293,-25,377,-34,0,0,8
2331,04/03/2009,3725,3892,3722,3891,208,86,208,502,166,0,1,7
2332,05/03/2009,3864,3864,3695,3695,-101,142,-207,-166,-169,1,0,7
2333,06/03/2009,3699,3769,3638,3666,163,231,-391,3,-33,0,0,7
2334,09/03/2009,3677,3706,3589,3692,-143,263,135,255,15,0,1,6
2335,10/03/2009,3716,3908,3681,3887,320,122,8,450,171,0,1,6
2336,11/03/2009,3867,3995,3829,3914,-48,47,37,36,47,0,1,6
2337,12/03/2009,3890,3971,3802,3956,-45,93,-79,-31,66,0,0,6
2338,13/03/2009,3988,4054,3937,3954,239,67,-34,272,-34,0,0,6
2339,16/03/2009,3991,4063,3983,4045,136,138,54,328,54,0,1,6
2340,17/03/2009,4041,4046,3947,3988,-15,-219,-53,-287,-53,1,0,6
2341,18/03/2009,4024,4067,3949,3996,-9,-99,45,-63,-28,1,0,7
2342,19/03/2009,4014,4138,4002,4043,-175,-122,-64,-361,29,0,0,7
2343,20/03/2009,4006,4082,3995,4069,260,158,106,524,63,0,1,6
2344,23/03/2009,4109,4185,4102,4176,229,186,39,454,67,0,1,7
2345,24/03/2009,4201,4240,4151,4187,439,-153,94,380,-14,0,0,7
2346,25/03/2009,4175,4262,4140,4223,177,154,121,452,48,0,1,6
2347,26/03/2009,4227,4263,4211,4259,392,11,-40,363,32,0,1,6
2348,27/03/2009,4252,4272,4156,4204,350,-33,-52,265,-48,0,0,7
2349,30/03/2009,4175,4175,3987,3989,-313,-376,88,-601,-186,1,0,7
2350,31/03/2009,4008,4092,4007,4085,169,14,161,344,77,0,1,7
2351,01/04/2009,4075,4149,3997,4131,241,56,-122,175,56,0,1,7
2352,02/04/2009,4174,4405,4173,4382,475,160,144,779,208,0,1,7
2353,03/04/2009,4353,4456,4335,4385,112,102,83,297,32,0,1,8
2354,06/04/2009,4422,4457,4306,4350,102,-130,-130,-158,-72,1,0,8
2355,07/04/2009,4359,4379,4276,4322,-32,124,72,164,-37,0,0,8
2356,08/04/2009,4286,4377,4229,4358,572,546,-91,1027,72,0,1,8
2357,09/04/2009,4397,4511,4378,4491,100,-350,179,-71,94,0,0,8
2358,13/04/2009,4491,4491,4491,4491,236,53,53,342,0,0,0,7
2359,14/04/2009,4489,4584,4461,4557,-30,-3,-4,-37,68,0,0,7
2360,15/04/2009,4528,4559,4488,4550,202,35,17,254,22,0,1,6
2361,16/04/2009,4570,4645,4532,4609,139,-5,-97,37,39,0,1,6
2362,17/04/2009,4622,4686,4591,4677,392,121,121,634,55,0,1,6
2363,20/04/2009,4656,4668,4471,4486,77,-198,-198,-319,-170,1,0,6
2364,21/04/2009,4489,4543,4391,4502,-225,16,119,-90,13,0,0,6
2365,22/04/2009,4509,4595,4456,4594,95,47,-32,110,85,0,1,5
2366,23/04/2009,4565,4609,4524,4538,286,12,-172,126,-27,0,0,6
2367,24/04/2009,4545,4675,4543,4674,120,445,26,591,129,0,1,5
2368,27/04/2009,4625,4713,4572,4694,111,75,56,242,69,0,1,6
2369,28/04/2009,4660,4661,4548,4607,-253,-265,-61,-579,-53,1,0,7
2370,29/04/2009,4617,4722,4612,4705,287,21,207,515,88,0,1,8
2371,30/04/2009,4733,4837,4710,4769,-236,187,-33,-82,36,0,0,8
2372,01/05/2009,4769,4769,4769,4769,159,124,221,504,0,0,0,7
2373,04/05/2009,4790,4909,4782,4902,187,-142,-37,8,112,0,1,6
2374,05/05/2009,4897,4928,4844,4853,239,-187,-187,-135,-44,1,0,6
2375,06/05/2009,4849,4946,4828,4881,-47,-161,-143,-351,32,0,0,7
2376,07/05/2009,4899,4980,4792,4804,-216,124,-143,-235,-95,1,0,6
2377,08/05/2009,4852,4966,4847,4914,-40,716,137,813,62,0,1,7
2378,11/05/2009,4907,4918,4832,4867,615,177,-141,651,-40,0,0,7
2379,12/05/2009,4837,4927,4822,4854,-388,46,215,-127,17,0,0,6
2380,13/05/2009,4865,4881,4714,4728,-217,307,-58,32,-137,0,0,5
2381,14/05/2009,4728,4745,4653,4738,-112,77,299,264,10,0,1,4
2382,15/05/2009,4757,4777,4685,4738,-264,-160,220,-204,-19,1,0,5
2383,18/05/2009,4703,4859,4656,4852,365,564,62,991,149,0,1,6
2384,19/05/2009,4875,5005,4875,4960,177,246,-60,363,85,0,1,6
2385,20/05/2009,4954,5061,4950,5039,633,-248,100,485,85,0,1,6
2386,21/05/2009,4997,4997,4875,4901,-86,-127,-53,-266,-96,1,0,7
2387,22/05/2009,4905,4965,4869,4919,63,-106,-246,-289,14,0,0,7
2388,25/05/2009,4936,4942,4830,4918,-226,-80,391,85,-18,0,0,6
2389,26/05/2009,4891,4994,4803,4986,31,277,125,433,95,0,1,6
2390,27/05/2009,5002,5036,4963,5001,7,-378,104,-267,-1,1,0,7
2391,28/05/2009,4959,4987,4885,4933,16,187,-269,-66,-26,1,0,8
2392,29/05/2009,4965,5010,4928,4941,8,-368,38,-322,-24,1,0,8
2393,01/06/2009,4992,5157,4991,5143,247,295,149,691,151,0,1,8
2394,02/06/2009,5116,5178,5096,5144,507,75,50,632,28,0,1,8
2395,03/06/2009,5150,5158,5037,5055,-26,-65,-90,-181,-95,1,0,8
2396,04/06/2009,5060,5121,5044,5065,-494,-75,187,-382,5,0,0,8
2397,05/06/2009,5093,5165,5048,5077,-330,-60,158,-232,-16,1,0,7
2398,08/06/2009,5061,5061,4970,5005,120,110,51,281,-56,0,0,8
2399,09/06/2009,5018,5064,4982,4998,-24,197,-199,-26,-20,1,0,8
2400,10/06/2009,5048,5133,5035,5051,-210,-191,-122,-523,3,0,0,8
2401,11/06/2009,5040,5121,5038,5107,18,114,46,178,67,0,1,7
2402,12/06/2009,5098,5109,5044,5069,-116,13,-77,-180,-29,1,0,7
2403,15/06/2009,5051,5051,4886,4890,-92,-254,-162,-508,-161,1,0,7
2404,16/06/2009,4900,4934,4870,4891,52,-220,-77,-245,-9,1,0,7
2405,17/06/2009,4883,4887,4761,4800,-75,-136,-176,-387,-83,1,0,7
2406,18/06/2009,4810,4859,4769,4837,-161,-319,139,-341,27,0,0,7
2407,19/06/2009,4845,4879,4816,4839,162,-475,-31,-344,-6,1,0,7
2408,22/06/2009,4837,4846,4693,4693,-80,-792,96,-776,-144,1,0,7
2409,23/06/2009,4680,4753,4670,4707,29,105,-56,78,27,0,1,8
2410,24/06/2009,4729,4840,4698,4836,148,347,73,568,107,0,1,8
2411,25/06/2009,4838,4838,4720,4801,-230,-51,47,-234,-37,1,0,9
2412,26/06/2009,4818,4867,4754,4776,-251,-682,30,-903,-42,1,0,9
2413,29/06/2009,4768,4901,4763,4885,168,247,47,462,117,0,1,9
2414,30/06/2009,4897,4906,4790,4809,-335,-58,-250,-643,-88,1,0,9
2415,01/07/2009,4821,4930,4819,4905,362,121,265,748,84,0,1,9
2416,02/07/2009,4891,4891,4718,4718,-299,-310,-150,-759,-173,1,0,9
2417,03/07/2009,4738,4748,4685,4708,-39,-75,-126,-240,-30,1,0,10
2418,06/07/2009,4670,4687,4611,4652,118,-120,-126,-128,-18,1,0,10
2419,07/07/2009,4663,4703,4591,4598,78,-458,-307,-687,-65,1,0,10
2420,08/07/2009,4595,4631,4558,4573,43,12,-118,-63,-22,1,0,10
2421,09/07/2009,4600,4670,4596,4630,234,221,28,483,30,0,1,10
2422,10/07/2009,4613,4645,4570,4576,162,122,-172,112,-37,0,0,10
2423,13/07/2009,4565,4722,4524,4722,-263,549,204,490,157,0,1,9
2424,14/07/2009,4734,4803,4706,4782,62,83,243,388,48,0,1,9
2425,15/07/2009,4799,4928,4799,4928,86,4,129,219,129,0,1,9
2426,16/07/2009,4921,4999,4904,4957,24,88,36,148,36,0,1,9
2427,17/07/2009,4980,5018,4961,4978,149,-118,11,42,-2,0,0,9
2428,20/07/2009,5014,5064,5008,5030,45,12,22,79,16,0,1,8
2429,21/07/2009,5041,5141,5027,5094,-497,-48,-33,-578,53,0,0,8
2430,22/07/2009,5099,5138,5050,5122,-30,23,23,16,23,0,1,7
2431,23/07/2009,5129,5259,5101,5247,24,120,120,264,118,0,1,7
2432,24/07/2009,5234,5302,5202,5229,-4,-5,-5,-14,-5,1,0,7
2433,27/07/2009,5269,5310,5216,5252,39,114,-3,150,-17,0,0,8
2434,28/07/2009,5262,5304,5174,5175,-86,-336,-401,-823,-87,1,0,7
2435,29/07/2009,5169,5308,5159,5270,159,175,-388,-54,101,0,0,7
2436,30/07/2009,5294,5397,5252,5361,187,-63,131,255,67,0,1,6
2437,31/07/2009,5349,5383,5304,5332,146,-142,-92,-88,-17,1,0,6
2438,03/08/2009,5331,5463,5309,5427,-98,206,304,412,96,0,1,7
2439,04/08/2009,5419,5428,5360,5417,419,32,-58,393,-2,0,0,7
2440,05/08/2009,5406,5452,5334,5353,-205,-80,-176,-461,-53,1,0,7
2441,06/08/2009,5390,5422,5340,5370,-91,-503,-243,-837,-20,1,0,7
2442,07/08/2009,5366,5481,5313,5459,120,199,146,465,93,0,1,7
2443,10/08/2009,5452,5452,5391,5418,512,-336,-36,140,-34,0,0,7
2444,11/08/2009,5423,5455,5272,5286,-388,-635,-425,-1448,-137,1,0,7
2445,12/08/2009,5283,5368,5252,5350,-63,52,-57,-68,67,0,0,7
2446,13/08/2009,5358,5455,5358,5401,101,-539,118,-320,43,0,0,7
2447,14/08/2009,5403,5444,5290,5309,-212,121,58,-33,-94,1,0,6
2448,17/08/2009,5296,5296,5174,5202,-57,345,136,424,-94,0,0,6
2449,18/08/2009,5218,5251,5200,5251,-168,-258,11,-415,33,0,0,5
2450,19/08/2009,5210,5254,5159,5232,98,88,162,348,22,0,1,5
2451,20/08/2009,5262,5326,5262,5311,323,270,-47,546,49,0,1,5
2452,21/08/2009,5296,5478,5286,5463,538,453,306,1297,167,0,1,5
2453,24/08/2009,5483,5532,5481,5520,63,-1,-143,-81,37,0,0,5
2454,25/08/2009,5483,5576,5473,5557,118,-127,-54,-63,74,0,0,5
2455,26/08/2009,5549,5572,5500,5522,38,-25,-7,6,-27,0,0,4
2456,27/08/2009,5513,5540,5432,5470,107,84,-107,84,-43,0,0,4
2457,28/08/2009,5512,5574,5502,5517,689,414,-46,1057,5,0,1,4
2458,31/08/2009,5475,5496,5438,5458,141,-302,-34,-195,-17,1,0,4
2459,01/09/2009,5479,5507,5327,5327,-775,-172,-146,-1093,-152,1,0,5
2460,02/09/2009,5326,5338,5263,5320,51,-28,-222,-199,-6,1,0,6
2461,03/09/2009,5332,5364,5278,5301,58,-31,145,172,-31,0,0,6
2462,04/09/2009,5329,5404,5320,5384,-28,129,18,119,55,0,1,5
2463,07/09/2009,5401,5477,5401,5464,-71,-90,148,-13,63,0,0,5
2464,08/09/2009,5475,5503,5455,5482,317,-98,-105,114,7,0,1,5
2465,09/09/2009,5464,5578,5450,5574,232,-8,6,230,110,0,1,6
2466,10/09/2009,5596,5627,5547,5595,159,-142,-37,-20,-1,1,0,7
2467,11/09/2009,5602,5653,5602,5624,-51,10,-30,-71,22,0,0,8
2468,14/09/2009,5600,5624,5532,5620,407,124,36,567,20,0,1,7
2469,15/09/2009,5637,5650,5585,5629,-108,-61,-173,-342,-8,1,0,7
2470,16/09/2009,5641,5713,5641,5700,612,-108,72,576,59,0,1,7
2471,17/09/2009,5722,5748,5703,5731,275,8,-5,278,9,0,1,7
2472,18/09/2009,5711,5761,5701,5704,-212,-18,-107,-337,-7,1,0,8
2473,21/09/2009,5699,5699,5618,5669,-411,-42,-57,-510,-30,1,0,8
2474,22/09/2009,5687,5753,5687,5709,202,-68,116,250,22,0,1,9
2475,23/09/2009,5706,5754,5672,5702,31,-294,94,-169,-4,1,0,9
2476,24/09/2009,5684,5742,5586,5605,-320,5,116,-199,-79,1,0,9
2477,25/09/2009,5616,5620,5559,5581,197,-278,27,-54,-35,1,0,9
2478,28/09/2009,5595,5736,5555,5736,-117,127,148,158,141,0,1,10
2479,29/09/2009,5737,5756,5690,5714,-286,282,-214,-218,-23,1,0,10
2480,30/09/2009,5728,5745,5619,5675,-430,8,-69,-491,-53,1,0,10
2481,01/10/2009,5682,5727,5554,5555,104,-458,-34,-388,-127,1,0,10
2482,02/10/2009,5533,5537,5442,5468,-175,639,-65,399,-65,0,0,10
2483,05/10/2009,5478,5512,5440,5509,-17,-165,31,-151,31,0,0,9
2484,06/10/2009,5519,5662,5519,5658,228,552,241,1021,139,0,1,8
2485,07/10/2009,5650,5691,5626,5641,63,-38,-101,-76,-9,1,0,8
2486,08/10/2009,5680,5728,5667,5717,333,308,-1,640,37,0,1,8
2487,09/10/2009,5701,5748,5674,5712,186,-76,-9,101,11,0,1,8
2488,12/10/2009,5727,5814,5727,5783,192,-124,127,195,56,0,1,8
2489,13/10/2009,5778,5787,5695,5714,-27,-182,-162,-371,-64,1,0,8
2490,14/10/2009,5757,5860,5757,5854,112,128,37,277,97,0,1,8
2491,15/10/2009,5853,5869,5806,5831,-30,35,337,342,-22,0,0,8
2492,16/10/2009,5846,5886,5731,5743,-47,91,-193,-149,-103,1,0,7
2493,19/10/2009,5761,5857,5761,5853,-203,-172,392,17,92,0,1,8
2494,20/10/2009,5856,5888,5801,5812,-286,-124,-110,-520,-44,1,0,9
2495,21/10/2009,5827,5858,5737,5833,-195,24,-239,-410,6,0,0,9
2496,22/10/2009,5806,5806,5713,5763,-179,-171,-231,-581,-43,1,0,8
2497,23/10/2009,5788,5849,5732,5740,-193,44,23,-126,-48,1,0,8
2498,26/10/2009,5764,5799,5624,5642,-101,-146,-184,-431,-122,1,0,8
2499,27/10/2009,5653,5673,5598,5635,45,-18,-131,-104,-18,1,0,8
2500,28/10/2009,5640,5646,5494,5496,98,-47,-131,-80,-144,1,0,8
2501,29/10/2009,5492,5590,5462,5587,-219,95,95,-29,95,0,0,8
2502,30/10/2009,5593,5597,5395,5415,-490,-67,-178,-735,-178,1,0,8
2503,02/11/2009,5411,5472,5377,5431,1,95,-63,33,20,0,1,8
2504,03/11/2009,5412,5412,5313,5353,-114,560,40,486,-59,0,0,8
2505,04/11/2009,5378,5471,5365,5444,67,134,67,268,66,0,1,7
2506,05/11/2009,5405,5512,5356,5481,23,-260,-114,-351,76,0,0,8
2507,06/11/2009,5465,5527,5411,5488,-222,50,-23,-195,23,0,0,7
2508,09/11/2009,5514,5626,5514,5620,3,162,-71,94,106,0,1,6
2509,10/11/2009,5627,5651,5603,5613,125,-140,65,50,-14,0,0,6
2510,11/11/2009,5633,5706,5633,5668,-132,299,65,232,35,0,1,5
2511,12/11/2009,5658,5726,5633,5664,445,-12,104,537,6,0,1,5
2512,13/11/2009,5662,5701,5616,5687,429,84,208,721,25,0,1,6
2513,16/11/2009,5717,5813,5717,5805,114,6,328,448,88,0,1,6
2514,17/11/2009,5788,5802,5761,5778,21,-10,-130,-119,-10,1,0,6
2515,18/11/2009,5793,5843,5771,5788,-28,12,204,188,-5,0,0,7
2516,19/11/2009,5784,5792,5689,5702,260,69,-139,190,-82,0,0,6
2517,20/11/2009,5725,5745,5638,5663,223,165,-237,151,-62,0,0,6
2518,23/11/2009,5689,5823,5689,5801,271,105,113,489,112,0,1,6
2519,24/11/2009,5763,5814,5746,5769,-72,63,-77,-86,6,0,0,6
2520,25/11/2009,5795,5826,5754,5803,43,-299,57,-199,8,0,0,6
2521,26/11/2009,5785,5785,5597,5614,-116,-8,-202,-326,-171,1,0,5
2522,27/11/2009,5581,5719,5519,5686,17,-36,105,86,105,0,1,5
2523,30/11/2009,5692,5718,5608,5626,-138,28,19,-91,-66,1,0,5
2524,01/12/2009,5654,5777,5653,5777,99,761,123,983,123,0,1,5
2525,02/12/2009,5772,5813,5752,5782,45,-1205,-220,-1380,10,0,0,5
2526,03/12/2009,5805,5853,5755,5770,17,-635,52,-566,-35,1,0,5
2527,04/12/2009,5753,5859,5724,5818,-105,-101,157,-49,65,0,0,6
2528,07/12/2009,5812,5813,5743,5785,199,388,130,717,-27,0,0,6
2529,08/12/2009,5764,5810,5659,5689,63,167,-174,56,-75,0,0,5
2530,09/12/2009,5673,5712,5605,5648,-113,-88,-97,-298,-25,1,0,5
2531,10/12/2009,5647,5742,5637,5709,43,-120,314,237,62,0,1,6
2532,11/12/2009,5714,5793,5714,5756,-66,17,104,55,42,0,1,6
2533,14/12/2009,5803,5827,5779,5802,154,-50,-151,-47,-1,1,0,6
2534,15/12/2009,5816,5828,5752,5811,-48,34,106,92,-5,0,0,6
2535,16/12/2009,5813,5903,5812,5903,-127,-294,106,-315,90,0,0,5
2536,17/12/2009,5884,5891,5834,5844,435,39,-116,358,-40,0,0,5
2537,18/12/2009,5847,5901,5830,5831,-199,9,258,68,-16,0,0,4
2538,21/12/2009,5842,5936,5842,5931,-341,-148,56,-433,89,0,0,4
2539,22/12/2009,5939,5982,5930,5946,-20,-163,-58,-241,7,0,0,4
2540,23/12/2009,5966,5988,5935,5957,614,-119,-219,276,-9,0,0,4
2541,28/12/2009,5978,6011,5978,6003,-191,-177,-310,-678,25,0,0,3
2542,29/12/2009,6011,6027,6001,6012,417,-317,31,131,1,0,1,2
2543,30/12/2009,6002,6009,5949,5957,-191,-177,-310,-678,-45,1,0,2
2544,04/01/2010,5976,6048,5974,6048,270,895,104,1269,72,0,1,2
2545,05/01/2010,6044,6058,6016,6032,-356,-106,21,-441,-12,1,0,3
2546,06/01/2010,6032,6048,5997,6034,180,-101,159,238,2,0,1,4
2547,07/01/2010,6017,6038,5961,6019,-226,12,159,-55,2,0,0,5
2548,08/01/2010,6029,6053,5972,6038,209,-260,-87,-138,9,0,0,5
2549,11/01/2010,6058,6094,6031,6040,-452,61,-130,-521,-18,1,0,5
2550,12/01/2010,6039,6056,5925,5943,75,254,-60,269,-96,0,0,6
2551,13/01/2010,5937,5974,5925,5963,160,345,165,670,26,0,1,6
2552,14/01/2010,5999,6010,5952,5989,-71,-88,-199,-358,-10,1,0,7
2553,15/01/2010,5997,6025,5867,5876,-254,-785,-44,-1083,-121,1,0,7
2554,18/01/2010,5898,5923,5878,5919,280,373,21,674,21,0,1,7
2555,19/01/2010,5905,5989,5850,5976,-6,261,27,282,71,0,1,7
2556,20/01/2010,5964,5973,5832,5852,36,512,-197,351,-112,0,0,7
2557,21/01/2010,5878,5909,5742,5747,-336,-133,-4,-473,-131,1,0,6
2558,22/01/2010,5736,5741,5639,5695,131,-399,82,-186,-41,1,0,7
2559,25/01/2010,5663,5694,5625,5631,-34,8,-84,-110,-32,1,0,8
2560,26/01/2010,5594,5676,5574,5669,136,325,96,557,75,0,1,8
2561,27/01/2010,5644,5674,5589,5643,130,182,-86,226,-1,0,0,9
2562,28/01/2010,5687,5719,5540,5540,-96,243,-326,-179,-147,1,0,8
2563,29/01/2010,5566,5658,5556,5609,-76,-272,10,-338,43,0,0,8
2564,01/02/2010,5588,5674,5568,5654,124,-297,-144,-317,66,0,0,7
2565,02/02/2010,5664,5723,5625,5710,17,-89,85,13,46,0,1,6
2566,03/02/2010,5715,5734,5657,5672,130,139,189,458,-43,0,0,6
2567,04/02/2010,5671,5697,5523,5533,203,-361,-16,-174,-138,1,0,6
2568,05/02/2010,5516,5527,5433,5434,-625,217,-44,-452,-82,1,0,6
2569,08/02/2010,5476,5505,5434,5485,-39,4,-164,-199,9,0,0,6
2570,09/02/2010,5485,5538,5462,5498,69,-281,27,-185,13,0,0,5
2571,10/02/2010,5534,5592,5505,5536,-263,-365,171,-457,2,0,0,4
2572,11/02/2010,5563,5581,5454,5504,-10,-786,-94,-890,-59,1,0,4
2573,12/02/2010,5550,5565,5460,5500,-250,100,-13,-163,-50,1,0,4
2574,15/02/2010,5526,5547,5502,5511,-164,-533,-67,-764,-15,1,0,5
2575,16/02/2010,5573,5592,5498,5592,-130,-336,61,-405,19,0,0,6
2576,17/02/2010,5640,5682,5635,5648,-207,-136,40,-303,8,0,0,5
2577,18/02/2010,5646,5692,5626,5680,112,88,104,304,34,0,1,5
2578,19/02/2010,5627,5730,5627,5722,666,110,328,1104,95,0,1,5
2579,22/02/2010,5741,5744,5684,5688,177,12,-59,130,-53,0,0,5
2580,23/02/2010,5716,5732,5584,5604,-138,-57,-98,-293,-112,1,0,5
2581,24/02/2010,5622,5640,5572,5616,81,281,133,495,-6,0,0,6
2582,25/02/2010,5563,5656,5518,5532,170,-14,117,273,-31,0,0,6
2583,26/02/2010,5589,5605,5530,5598,-284,270,139,125,9,0,1,5
2584,01/03/2010,5653,5718,5641,5714,-272,50,12,-210,61,0,0,5
2585,02/03/2010,5728,5780,5710,5777,-45,207,103,265,49,0,1,4
2586,03/03/2010,5759,5829,5750,5818,526,211,133,870,59,0,1,5
2587,04/03/2010,5774,5823,5768,5795,123,-1,-143,-21,21,0,0,6
2588,05/03/2010,5816,5880,5808,5877,-56,-77,-25,-158,61,0,0,5
2589,08/03/2010,5892,5894,5865,5876,383,-134,-134,115,-16,0,0,4
2590,09/03/2010,5873,5900,5838,5886,-166,156,-70,-80,13,0,0,4
2591,10/03/2010,5883,5952,5875,5937,-77,-39,107,-9,54,0,0,3
2592,11/03/2010,5913,5955,5907,5929,334,282,242,858,16,0,1,3
2593,12/03/2010,5945,5990,5934,5945,-89,-177,-52,-318,0,0,0,4
2594,15/03/2010,5934,5953,5898,5904,-220,571,177,528,-30,0,0,3
2595,16/03/2010,5935,5991,5930,5971,-410,366,-10,-54,36,0,0,3
2596,17/03/2010,5999,6036,5991,6024,7,-404,-305,-702,25,0,0,2
2597,18/03/2010,6005,6039,5996,6012,18,92,71,181,7,0,1,1
2598,19/03/2010,6032,6042,5957,5982,180,-101,159,238,-50,0,0,2
2599,22/03/2010,5961,5988,5911,5988,119,320,-146,293,27,0,1,2
2600,23/03/2010,5987,6031,5981,6017,122,-85,-66,-29,30,0,0,3
2601,24/03/2010,6038,6045,5965,6039,-195,130,-12,-77,1,0,0,3
2602,25/03/2010,6044,6140,6038,6133,-423,197,-424,-650,89,0,0,3
2603,26/03/2010,6126,6136,6106,6120,463,164,295,922,-6,0,0,2
2604,29/03/2010,6150,6173,6128,6157,-168,-132,-11,-311,7,0,0,2
2605,30/03/2010,6188,6204,6136,6142,140,-364,-236,-460,-46,1,0,2
2606,31/03/2010,6139,6162,6108,6154,44,616,17,677,15,0,1,3
2607,01/04/2010,6189,6239,6187,6236,474,-76,482,880,47,0,1,4
2608,05/04/2010,6236,6236,6236,6236,-20,81,207,268,0,0,0,4
2609,06/04/2010,6250,6265,6214,6252,191,-164,-210,-183,2,0,0,4
2610,07/04/2010,6248,6256,6209,6222,-432,102,-46,-376,-26,1,0,3
2611,08/04/2010,6200,6207,6138,6172,-331,-1119,-620,-2070,-28,1,0,4
2612,09/04/2010,6226,6254,6217,6250,173,536,89,798,24,0,1,5
2613,12/04/2010,6284,6285,6224,6251,42,-133,71,-20,-33,1,0,6
2614,13/04/2010,6236,6251,6200,6231,-365,141,116,-108,-5,1,0,7
2615,14/04/2010,6269,6305,6250,6278,183,-93,-136,-46,9,0,0,8
2616,15/04/2010,6287,6311,6250,6291,-303,-918,-107,-1328,4,0,0,7
2617,16/04/2010,6265,6305,6163,6181,-151,139,-241,-253,-84,1,0,6
2618,19/04/2010,6159,6191,6140,6162,28,229,-43,214,3,0,1,6
2619,20/04/2010,6194,6268,6173,6264,9,343,-93,259,70,0,1,7
2620,21/04/2010,6281,6281,6229,6230,210,559,-52,717,-51,0,0,8
2621,22/04/2010,6229,6286,6141,6169,160,-254,-66,-160,-60,1,0,7
2622,23/04/2010,6193,6288,6170,6260,197,367,368,932,67,0,1,7
2623,26/04/2010,6317,6342,6300,6332,193,322,144,659,15,0,1,7
2624,27/04/2010,6332,6333,6160,6160,-286,299,-18,-5,-172,1,0,7
2625,28/04/2010,6141,6159,6024,6084,-43,-156,-66,-265,-57,1,0,7
2626,29/04/2010,6111,6159,6073,6145,199,-162,34,71,34,0,1,8
2627,30/04/2010,6156,6206,6086,6136,39,83,62,184,-20,0,0,9
2628,03/05/2010,6123,6190,6090,6167,89,93,62,244,44,0,1,8
2629,04/05/2010,6176,6197,5995,6007,-249,-820,-169,-1238,-169,1,0,8
2630,05/05/2010,6021,6031,5929,5958,-170,-137,-256,-563,-63,1,0,8
2631,06/05/2010,5920,6009,5884,5908,4,-521,33,-484,-12,1,0,9
2632,07/05/2010,5791,5905,5655,5715,139,-157,0,-18,-76,1,0,9
2633,10/05/2010,5814,6018,5806,6018,204,265,204,673,204,0,1,9
2634,11/05/2010,5922,6042,5918,6038,-55,-40,63,-32,116,0,0,9
2635,12/05/2010,6026,6217,6006,6183,46,933,264,1243,157,0,1,8
2636,13/05/2010,6241,6277,6197,6252,11,11,204,226,11,0,1,8
2637,14/05/2010,6226,6234,6015,6057,-256,-37,-278,-571,-169,1,0,8
2638,17/05/2010,6030,6152,6026,6067,271,51,178,500,37,0,1,9
2639,18/05/2010,6144,6181,6114,6156,-128,-87,-373,-588,12,0,0,9
2640,19/05/2010,6092,6125,5972,5989,-33,-93,-185,-311,-103,1,0,8
2641,20/05/2010,6023,6044,5781,5868,-502,-246,-330,-1078,-155,1,0,8
2642,21/05/2010,5835,5873,5689,5829,117,-6,249,360,-6,0,0,8
2643,24/05/2010,5858,5872,5734,5806,-154,-292,-110,-556,-52,1,0,7
2644,25/05/2010,5660,5690,5608,5670,204,10,-110,104,10,0,1,7
2645,26/05/2010,5735,5828,5721,5758,23,-29,23,17,23,0,1,8
2646,27/05/2010,5803,5952,5802,5937,-13,216,114,317,134,0,1,8
2647,28/05/2010,5963,5981,5927,5946,-66,747,195,876,-17,0,0,8
2648,31/05/2010,5934,5994,5931,5964,-118,83,-195,-230,30,0,0,7
2649,01/06/2010,5944,6012,5834,5981,83,-209,-195,-321,37,0,0,6
2650,02/06/2010,5923,5992,5869,5981,-409,-146,208,-347,58,0,0,6
2651,03/06/2010,6076,6102,6046,6055,38,70,208,316,-21,0,0,5
2652,04/06/2010,6081,6115,5913,5939,-182,-156,-132,-470,-142,1,0,4
2653,07/06/2010,5876,5954,5852,5905,130,139,-37,232,29,0,1,5
2654,08/06/2010,5917,5923,5799,5869,3,-53,207,157,-48,0,0,5
2655,09/06/2010,5896,5994,5833,5985,-158,-17,85,-90,89,0,0,4
2656,10/06/2010,5959,6089,5925,6057,60,119,-3,176,98,0,1,3
2657,11/06/2010,6083,6085,5983,6048,-96,162,-55,11,-35,0,0,3
2658,14/06/2010,6113,6137,6093,6125,59,-395,12,-324,12,0,0,3
2659,15/06/2010,6089,6194,6089,6175,-126,-31,261,104,86,0,1,3
2660,16/06/2010,6203,6207,6143,6191,359,-116,-175,68,-12,0,0,4
2661,17/06/2010,6182,6241,6165,6224,334,123,173,630,42,0,1,4
2662,18/06/2010,6224,6257,6190,6217,611,8,5,624,-7,0,0,5
2663,21/06/2010,6320,6331,6263,6293,-248,-202,28,-422,-27,1,0,4
2664,22/06/2010,6255,6296,6216,6269,383,99,189,671,14,0,1,4
2665,23/06/2010,6219,6272,6179,6205,-87,-297,-265,-649,-14,1,0,5
2666,24/06/2010,6232,6235,6097,6115,-80,115,-423,-388,-117,1,0,6
2667,25/06/2010,6116,6150,6040,6071,43,-157,-48,-162,-45,1,0,6
2668,28/06/2010,6097,6169,6060,6157,9,60,60,129,60,0,1,7
2669,29/06/2010,6062,6069,5935,5952,-348,26,113,-209,-110,1,0,8
2670,30/06/2010,5972,6001,5938,5966,-14,-6,-6,-26,-6,1,0,8
2671,01/07/2010,5886,5954,5827,5857,4,-29,-29,-54,-29,1,0,9
2672,02/07/2010,5885,5941,5833,5834,-51,-446,-125,-622,-51,1,0,9
2673,05/07/2010,5854,5861,5809,5816,-38,88,-38,12,-38,0,0,10
2674,06/07/2010,5847,5996,5842,5941,-138,-157,-94,-389,94,0,0,9
2675,07/07/2010,5896,5998,5849,5993,-113,257,233,377,97,0,1,8
2676,08/07/2010,6026,6058,6007,6036,197,747,-39,905,10,0,1,8
2677,09/07/2010,6070,6079,6039,6065,19,436,1,456,-5,0,0,8
2678,12/07/2010,6080,6120,6062,6077,-156,16,-258,-398,-3,1,0,7
2679,13/07/2010,6078,6201,6076,6191,269,213,-83,399,113,0,1,7
2680,14/07/2010,6215,6227,6161,6210,-73,-233,-5,-311,-5,1,0,7
2681,15/07/2010,6188,6248,6127,6149,-25,-85,-15,-125,-39,1,0,7
2682,16/07/2010,6166,6205,6019,6040,146,-29,-248,-131,-126,1,0,7
2683,19/07/2010,6035,6083,5994,6009,206,-129,-71,6,-26,0,0,7
2684,20/07/2010,6039,6053,5906,5967,-146,-17,-302,-465,-72,1,0,7
2685,21/07/2010,6012,6060,5977,5990,395,-28,-207,160,-22,0,0,8
2686,22/07/2010,5971,6148,5962,6142,460,174,229,863,171,0,1,7
2687,23/07/2010,6125,6190,6112,6166,50,-66,167,151,41,0,1,7
2688,26/07/2010,6201,6201,6132,6194,34,178,146,358,-7,0,0,8
2689,27/07/2010,6211,6254,6190,6207,130,-330,69,-131,-4,1,0,7
2690,28/07/2010,6239,6249,6148,6179,30,11,148,189,-60,0,0,7
2691,29/07/2010,6203,6243,6124,6135,51,-139,34,-54,-68,1,0,6
2692,30/07/2010,6123,6185,6059,6148,151,61,461,673,25,0,1,6
2693,02/08/2010,6188,6304,6183,6292,420,-57,260,623,104,0,1,6
2694,03/08/2010,6280,6310,6266,6308,-180,-78,9,-249,28,0,0,7
2695,04/08/2010,6288,6362,6264,6331,580,187,303,1070,43,0,1,6
2696,05/08/2010,6333,6383,6321,6334,682,21,-117,586,1,0,1,7
2697,06/08/2010,6361,6387,6245,6260,-356,-248,-149,-753,-101,1,0,7
2698,09/08/2010,6327,6356,6318,6352,-92,-131,350,127,25,0,1,7
2699,10/08/2010,6316,6333,6248,6286,-384,-68,78,-374,-30,1,0,8
2700,11/08/2010,6235,6237,6144,6154,-265,11,-87,-341,-81,1,0,8
2701,12/08/2010,6142,6173,6098,6135,-7,-7,299,285,-7,0,0,9
2702,13/08/2010,6163,6169,6069,6110,-93,108,259,274,-53,0,0,8
2703,16/08/2010,6133,6157,6062,6111,-126,169,11,54,-22,0,0,7
2704,17/08/2010,6125,6215,6124,6206,232,161,259,652,81,0,1,6
2705,18/08/2010,6183,6217,6156,6186,-177,-517,-278,-972,3,0,0,7
2706,19/08/2010,6216,6229,6071,6075,-44,-539,-212,-795,-141,1,0,6
2707,20/08/2010,6080,6097,6000,6005,-80,-340,-248,-668,-75,1,0,6
2708,23/08/2010,6017,6055,5995,6011,41,-63,249,227,-6,0,0,6
2709,24/08/2010,5963,5976,5869,5935,-122,-315,-125,-562,-28,1,0,5
2710,25/08/2010,5925,5955,5838,5900,-33,-479,59,-453,-25,1,0,5
2711,26/08/2010,5937,5949,5897,5913,17,73,-31,59,-24,0,0,5
2712,27/08/2010,5900,5957,5845,5951,-54,-423,122,-355,51,0,0,5
2713,30/08/2010,5973,5978,5890,5912,-29,-640,-235,-904,-61,1,0,5
2714,31/08/2010,5846,5926,5834,5925,100,73,168,341,79,0,1,6
2715,01/09/2010,5937,6088,5876,6084,-143,59,-106,-190,147,0,0,6
2716,02/09/2010,6072,6104,6053,6084,-406,212,129,-65,12,0,0,6
2717,03/09/2010,6092,6178,6088,6135,40,36,-48,28,43,0,1,5
2718,06/09/2010,6156,6165,6141,6155,60,110,46,216,-1,0,0,5
2719,07/09/2010,6137,6139,6083,6118,524,-2,79,601,-19,0,0,5
2720,08/09/2010,6099,6180,6063,6164,-32,22,89,79,65,0,1,4
2721,09/09/2010,6142,6233,6134,6222,-33,264,46,277,80,0,1,4
2722,10/09/2010,6186,6225,6183,6215,-255,232,34,11,29,0,1,5
2723,13/09/2010,6259,6291,6232,6262,3,151,-117,37,3,0,1,6
2724,14/09/2010,6262,6288,6231,6275,633,66,87,786,13,0,1,6
2725,15/09/2010,6283,6288,6227,6262,-367,-106,21,-452,-21,1,0,6
2726,16/09/2010,6255,6281,6234,6250,219,173,253,645,-5,0,0,7
2727,17/09/2010,6298,6321,6186,6210,34,100,-111,23,-88,0,0,7
2728,20/09/2010,6231,6302,6220,6295,231,562,117,910,64,0,1,6
2729,21/09/2010,6281,6340,6276,6276,-362,-313,51,-624,-5,1,0,7
2730,22/09/2010,6286,6297,6192,6208,-467,169,-204,-502,-78,1,0,8
2731,23/09/2010,6252,6264,6129,6185,-191,-224,-123,-538,-67,1,0,8
2732,24/09/2010,6174,6310,6146,6298,-13,29,421,437,124,0,1,8
2733,27/09/2010,6308,6324,6272,6279,-118,56,-371,-433,-29,1,0,8
2734,28/09/2010,6258,6312,6198,6276,-382,115,-47,-314,18,0,0,8
2735,29/09/2010,6296,6326,6223,6247,-217,221,-345,-341,-49,1,0,7
2736,30/09/2010,6214,6339,6205,6229,338,-237,-202,-101,15,0,0,7
2737,01/10/2010,6244,6293,6187,6211,-157,-476,-426,-1059,-33,1,0,7
2738,04/10/2010,6205,6210,6129,6134,-210,-147,-330,-687,-71,1,0,8
2739,05/10/2010,6132,6233,6116,6216,273,594,132,999,84,0,1,8
2740,06/10/2010,6249,6290,6243,6271,223,-507,26,-258,22,0,0,8
2741,07/10/2010,6279,6322,6233,6276,-4,13,72,81,-3,0,0,7
2742,08/10/2010,6269,6295,6239,6292,317,49,147,513,23,0,1,6
2743,11/10/2010,6308,6325,6289,6310,-7,-144,-498,-649,2,0,0,6
2744,12/10/2010,6257,6317,6228,6305,-254,24,260,30,48,0,1,5
2745,13/10/2010,6340,6456,6335,6435,-557,242,171,-144,95,0,0,6
2746,14/10/2010,6446,6486,6445,6455,447,-35,300,712,9,0,1,5
2747,15/10/2010,6478,6513,6439,6492,350,17,-136,231,14,0,1,6
2748,18/10/2010,6466,6534,6463,6517,439,5,9,453,51,0,1,6
2749,19/10/2010,6508,6545,6472,6491,435,32,-122,345,-17,0,0,6
2750,20/10/2010,6470,6528,6461,6525,64,-111,-73,-120,55,0,0,5
2751,21/10/2010,6515,6622,6505,6611,229,252,121,602,96,0,1,5
2752,22/10/2010,6595,6624,6586,6606,712,148,123,983,11,0,1,6
2753,25/10/2010,6645,6669,6626,6639,-128,-31,70,-89,-6,1,0,6
2754,26/10/2010,6634,6646,6580,6614,463,-44,138,557,-20,0,0,7
2755,27/10/2010,6591,6629,6553,6568,180,180,-220,140,-23,0,0,6
2756,28/10/2010,6600,6645,6576,6595,-371,-16,-136,-523,-5,1,0,6
2757,29/10/2010,6586,6631,6569,6601,200,8,-47,161,15,0,1,6
2758,01/11/2010,6637,6671,6586,6605,-387,3,55,-329,-32,1,0,6
2759,02/11/2010,6600,6669,6597,6654,165,-176,98,87,54,0,1,6
2760,03/11/2010,6666,6683,6605,6618,-405,-1115,-184,-1704,-48,1,0,7
2761,04/11/2010,6678,6757,6676,6735,9,-58,195,146,57,0,1,8
2762,05/11/2010,6744,6775,6712,6754,147,-297,-201,-351,10,0,0,8
2763,08/11/2010,6746,6759,6728,6750,359,-380,-172,-193,4,0,0,7
2764,09/11/2010,6742,6811,6737,6788,-168,-380,-130,-678,46,0,0,6
2765,10/11/2010,6760,6784,6684,6720,682,-347,-48,287,-40,0,0,6
2766,11/11/2010,6748,6750,6700,6723,172,716,11,899,-25,0,0,6
2767,12/11/2010,6651,6759,6618,6735,-97,255,-285,-127,84,0,0,5
2768,15/11/2010,6705,6813,6680,6790,177,26,18,221,85,0,1,4
2769,16/11/2010,6751,6772,6663,6663,-306,-44,-259,-609,-88,1,0,4
2770,17/11/2010,6659,6705,6654,6700,-43,375,41,373,41,0,1,4
2771,18/11/2010,6766,6836,6754,6832,-145,217,-152,-80,66,0,0,4
2772,19/11/2010,6841,6854,6794,6844,-39,-89,116,-12,3,0,0,3
2773,22/11/2010,6892,6902,6806,6822,-220,32,112,-76,-70,1,0,3
2774,23/11/2010,6792,6828,6705,6705,-388,-80,-237,-705,-87,1,0,4
2775,24/11/2010,6741,6834,6702,6824,-71,61,26,16,83,0,1,5
2776,25/11/2010,6835,6886,6823,6880,277,-635,-237,-595,45,0,0,6
2777,26/11/2010,6842,6872,6779,6849,-397,-32,-113,-542,7,0,0,6
2778,29/11/2010,6868,6908,6698,6698,-304,-688,-424,-1416,-170,1,0,6
2779,30/11/2010,6733,6764,6656,6688,-63,131,-57,11,-45,0,0,6
2780,01/12/2010,6748,6869,6737,6867,-35,761,1,727,119,0,1,5
2781,02/12/2010,6896,6959,6841,6958,-91,-139,153,-77,62,0,0,5
2782,03/12/2010,6947,6978,6914,6948,159,223,88,470,1,0,1,5
2783,06/12/2010,6970,6972,6927,6954,-165,66,165,66,-16,0,0,6
2784,07/12/2010,6988,7043,6962,7002,-270,104,121,-45,14,0,0,5
2785,08/12/2010,6976,7014,6957,6976,187,-63,131,255,0,0,0,4
2786,09/12/2010,7018,7021,6948,6964,-273,-261,-511,-1045,-54,1,0,3
2787,10/12/2010,6988,7018,6973,7006,530,4,-98,436,18,0,1,4
2788,13/12/2010,7028,7045,7018,7029,-397,-171,-130,-698,1,0,0,5
2789,14/12/2010,7025,7033,7011,7027,-220,-446,-127,-793,2,0,0,4
2790,15/12/2010,7007,7030,6964,7016,-266,-1205,-701,-2172,9,0,0,4
2791,16/12/2010,7013,7033,6992,7024,-97,59,-208,-246,11,0,0,3
2792,17/12/2010,7043,7043,6980,6982,200,2,-229,-27,-61,1,0,3
2793,20/12/2010,7000,7069,6993,7019,-34,147,4,117,19,0,1,3
2794,21/12/2010,7045,7088,7043,7078,183,106,-79,210,33,0,1,4
2795,22/12/2010,7079,7084,7068,7068,-392,-15,-110,-517,-11,1,0,5
2796,23/12/2010,7083,7083,7043,7058,228,109,149,486,-25,0,0,6
2797,27/12/2010,7055,7056,6943,6971,-203,-92,18,-277,-84,1,0,5
2798,28/12/2010,6985,6991,6958,6972,33,28,421,482,-13,0,0,5
2799,29/12/2010,6990,7008,6982,6995,187,101,317,605,5,0,1,5
2800,30/12/2010,6997,7008,6897,6914,-99,-595,-208,-902,-83,1,0,6
2801,31/12/2010,6914,6914,6914,6914,178,232,220,630,0,0,0,7
2802,03/01/2011,6973,7027,6970,6990,87,711,-50,748,17,0,1,7
2803,04/01/2011,6980,7026,6952,6975,-275,142,237,104,-5,0,0,7
2804,05/01/2011,6966,6967,6843,6940,310,143,238,691,-26,0,0,6
2805,06/01/2011,6949,7048,6949,6981,175,-333,-55,-213,32,0,0,5
2806,07/01/2011,6992,7011,6940,6948,-283,-391,-167,-841,-44,1,0,4
2807,10/01/2011,6920,6941,6836,6857,-228,-12,151,-89,-63,1,0,5
2808,11/01/2011,6879,6951,6861,6942,38,577,-8,607,63,0,1,5
2809,12/01/2011,6959,7070,6958,7069,143,-95,-62,-14,110,0,0,6
2810,13/01/2011,7076,7084,7036,7075,230,60,-5,285,-1,0,0,5
2811,14/01/2011,7055,7083,7015,7076,92,-321,-6,-235,21,0,0,4
2812,17/01/2011,7073,7087,7056,7078,-193,-98,22,-269,5,0,0,4
2813,18/01/2011,7100,7156,7099,7143,53,-26,-42,-15,43,0,0,3
2814,19/01/2011,7163,7165,7077,7083,580,-361,-119,100,-80,0,0,3
2815,20/01/2011,7075,7084,7009,7024,-304,-246,6,-544,-51,1,0,3
2816,21/01/2011,7048,7123,7024,7062,117,115,-40,192,14,0,1,4
2817,24/01/2011,7081,7090,7000,7068,223,-23,-159,41,-13,0,0,4
2818,25/01/2011,7097,7102,7044,7059,13,117,123,253,-38,0,0,3
2819,26/01/2011,7093,7161,7087,7127,-173,55,-107,-225,34,0,0,2
2820,27/01/2011,7121,7180,7114,7156,-75,17,95,37,35,0,1,2
2821,28/01/2011,7155,7177,7103,7103,-362,-478,-345,-1185,-52,1,0,3
2822,31/01/2011,7095,7107,7033,7077,193,93,-115,171,-18,0,0,4
2823,01/02/2011,7133,7191,7105,7184,75,62,3,140,51,0,1,4
2824,02/02/2011,7203,7222,7160,7184,-220,-132,72,-280,-19,1,0,5
2825,03/02/2011,7176,7199,7144,7194,173,26,482,681,18,0,1,6
2826,04/02/2011,7217,7227,7186,7216,199,43,112,354,-1,0,0,6
2827,07/02/2011,7222,7288,7214,7284,31,-264,113,-120,62,0,0,5
2828,08/02/2011,7274,7325,7273,7323,633,-248,100,485,49,0,1,5
2829,09/02/2011,7319,7351,7310,7321,102,81,227,410,2,0,1,6
2830,10/02/2011,7323,7341,7270,7340,-231,104,68,-59,17,0,0,7
2831,11/02/2011,7320,7390,7284,7371,512,-26,225,711,51,0,1,6
2832,14/02/2011,7404,7424,7378,7397,648,315,304,1267,-7,0,0,6
2833,15/02/2011,7398,7421,7376,7400,359,205,183,747,2,0,1,6
2834,16/02/2011,7414,7438,7400,7414,-384,-155,92,-447,0,0,0,6
2835,17/02/2011,7429,7435,7364,7406,22,-168,-160,-306,-23,1,0,5
2836,18/02/2011,7422,7427,7380,7427,-320,-610,-424,-1354,5,0,0,5
2837,21/02/2011,7412,7442,7311,7322,-286,-80,36,-330,-90,1,0,5
2838,22/02/2011,7293,7351,7260,7318,38,101,-43,96,25,0,1,6
2839,23/02/2011,7295,7311,7183,7195,178,-217,-43,-82,-100,1,0,6
2840,24/02/2011,7135,7156,7094,7130,43,275,-66,252,-5,0,0,6
2841,25/02/2011,7140,7194,7130,7185,-1,43,100,142,45,0,1,6
2842,28/02/2011,7174,7305,7149,7272,4,261,182,447,98,0,1,6
2843,01/03/2011,7310,7356,7194,7223,-12,147,-32,103,-87,0,0,7
2844,02/03/2011,7169,7203,7123,7181,86,-45,-27,14,12,0,1,6
2845,03/03/2011,7225,7294,7191,7226,89,50,-176,-37,1,0,0,7
2846,04/03/2011,7263,7311,7157,7179,75,-135,-98,-158,-84,1,0,6
2847,07/03/2011,7138,7271,7127,7162,211,113,-26,298,24,0,1,7
2848,08/03/2011,7211,7222,7072,7165,-144,-22,-42,-208,-46,1,0,7
2849,09/03/2011,7178,7218,7109,7132,-30,-136,-98,-264,-46,1,0,7
2850,10/03/2011,7079,7110,7022,7063,-309,194,-126,-241,-16,1,0,7
2851,11/03/2011,7002,7014,6963,6981,12,-579,4,-563,-21,1,0,8
2852,14/03/2011,6896,6946,6848,6867,124,59,96,279,-29,0,0,8
2853,15/03/2011,6669,6715,6483,6648,-21,-296,-21,-338,-21,1,0,7
2854,16/03/2011,6696,6733,6502,6514,-182,-34,-182,-398,-182,1,0,8
2855,17/03/2011,6558,6693,6517,6657,99,-24,99,174,99,0,1,8
2856,18/03/2011,6715,6761,6656,6664,158,-148,-51,-41,-51,1,0,9
2857,21/03/2011,6782,6830,6781,6816,204,34,10,248,34,0,1,9
2858,22/03/2011,6823,6826,6765,6781,70,-682,-5,-617,-42,1,0,9
2859,23/03/2011,6749,6807,6720,6804,39,247,-94,192,55,0,1,9
2860,24/03/2011,6798,6942,6787,6934,-37,81,266,310,136,0,1,9
2861,25/03/2011,6972,6985,6921,6946,44,123,152,319,-26,0,0,9
2862,28/03/2011,6932,6981,6916,6939,-225,58,-35,-202,7,0,0,8
2863,29/03/2011,6953,6960,6867,6934,167,-288,152,31,-19,0,0,8
2864,30/03/2011,7011,7065,7003,7057,450,189,-36,603,46,0,1,7
2865,31/03/2011,7068,7080,7041,7041,74,-147,-136,-209,-27,1,0,7
2866,01/04/2011,7087,7192,7087,7180,492,232,204,928,93,0,1,7
2867,04/04/2011,7179,7200,7168,7175,84,69,69,222,-4,0,0,7
2868,05/04/2011,7175,7186,7129,7175,-150,-198,-245,-593,0,0,0,6
2869,06/04/2011,7197,7243,7158,7215,-50,-126,121,-55,18,0,0,5
2870,07/04/2011,7212,7241,7175,7179,209,-147,-218,-156,-33,1,0,4
2871,08/04/2011,7227,7233,7195,7217,-233,-261,-378,-872,-10,1,0,4
2872,11/04/2011,7215,7225,7157,7205,-253,0,86,-167,-10,1,0,5
2873,12/04/2011,7131,7178,7089,7103,-394,-311,-273,-978,-28,1,0,6
2874,13/04/2011,7135,7201,7123,7178,43,101,67,211,43,0,1,7
2875,14/04/2011,7161,7185,7100,7147,203,89,-84,208,-14,0,0,7
2876,15/04/2011,7167,7193,7145,7178,-24,-394,-206,-624,11,0,0,6
2877,18/04/2011,7166,7175,6995,7027,130,-8,248,370,-139,0,0,5
2878,19/04/2011,7051,7079,7027,7039,-25,261,141,377,-12,0,0,5
2879,20/04/2011,7137,7261,7137,7249,-26,639,246,859,112,0,1,5
2880,21/04/2011,7295,7317,7280,7295,-384,155,-33,-262,0,0,0,6
2881,25/04/2011,7295,7295,7295,7295,463,-139,-16,308,0,0,0,5
2882,26/04/2011,7289,7360,7279,7357,697,-83,-139,475,68,0,1,4
2883,27/04/2011,7374,7429,7361,7405,533,124,36,693,31,0,1,4
2884,28/04/2011,7451,7480,7427,7475,118,-37,-37,44,24,0,1,4
2885,29/04/2011,7475,7515,7462,7514,246,74,-33,287,39,0,1,4
2886,02/05/2011,7571,7600,7528,7528,435,-46,-46,343,-43,0,0,5
2887,03/05/2011,7519,7524,7447,7501,73,-17,-43,13,-18,0,0,5
2888,04/05/2011,7475,7534,7355,7374,-205,-122,19,-308,-101,1,0,5
2889,05/05/2011,7416,7424,7291,7377,21,-144,32,-91,-39,1,0,6
2890,06/05/2011,7391,7502,7363,7492,284,31,113,428,101,0,1,6
2891,09/05/2011,7461,7489,7380,7411,-99,-117,-202,-418,-50,1,0,7
2892,10/05/2011,7446,7534,7423,7502,-265,52,246,33,56,0,1,8
2893,11/05/2011,7527,7566,7470,7495,-52,-170,79,-143,-32,1,0,8
2894,12/05/2011,7438,7444,7357,7444,346,172,-208,310,6,0,1,8
2895,13/05/2011,7486,7511,7391,7403,-334,233,29,-72,-83,1,0,8
2896,16/05/2011,7348,7403,7285,7388,-26,-132,19,-139,40,0,0,8
2897,17/05/2011,7347,7369,7254,7257,154,101,19,274,-90,0,0,8
2898,18/05/2011,7326,7341,7261,7304,126,-173,-22,-69,-22,1,0,8
2899,19/05/2011,7360,7416,7317,7358,-322,560,180,418,-2,0,0,8
2900,20/05/2011,7372,7410,7228,7267,-168,-146,4,-310,-105,1,0,7
2901,23/05/2011,7158,7166,7105,7122,12,-124,-77,-189,-36,1,0,7
2902,24/05/2011,7130,7202,7128,7151,262,446,262,970,21,0,1,7
2903,25/05/2011,7079,7184,7071,7171,130,235,95,460,92,0,1,7
2904,26/05/2011,7203,7217,7087,7114,-332,-412,-404,-1148,-89,1,0,7
2905,27/05/2011,7205,7208,7115,7163,-124,619,-21,474,-42,0,0,7
2906,30/05/2011,7165,7204,7147,7160,247,-257,-396,-406,-5,1,0,6
2907,31/05/2011,7240,7320,7239,7294,58,-89,77,46,54,0,1,7
2908,01/06/2011,7311,7315,7194,7217,109,173,-131,151,-94,0,0,8
2909,02/06/2011,7156,7158,7074,7074,-51,-361,251,-161,-82,1,0,7
2910,03/06/2011,7101,7120,7021,7109,-251,366,108,223,8,0,1,8
2911,06/06/2011,7095,7124,7063,7085,-89,210,324,445,-10,0,0,8
2912,07/06/2011,7094,7148,7087,7103,247,-689,-375,-817,9,0,0,7
2913,08/06/2011,7076,7089,6992,7060,30,260,296,586,-16,0,0,6
2914,09/06/2011,7062,7184,7036,7160,1,689,313,1003,98,0,1,5
2915,10/06/2011,7153,7183,7051,7070,228,-46,-48,134,-83,0,0,5
2916,13/06/2011,7076,7124,7040,7085,-394,-414,-341,-1149,9,0,0,5
2917,14/06/2011,7165,7231,7161,7205,-253,-290,-127,-670,40,0,0,4
2918,15/06/2011,7178,7202,7093,7115,-100,-204,-363,-667,-63,1,0,3
2919,16/06/2011,7062,7112,7018,7110,170,117,329,616,48,0,1,4
2920,17/06/2011,7084,7224,7037,7164,-122,245,189,312,80,0,1,4
2921,20/06/2011,7079,7158,7064,7150,-7,201,-498,-304,71,0,0,4
2922,21/06/2011,7203,7286,7177,7286,249,118,206,573,83,0,1,4
2923,22/06/2011,7286,7310,7262,7278,52,-75,-8,-31,-8,1,0,5
2924,23/06/2011,7225,7237,7119,7149,-38,194,46,202,-76,0,0,6
2925,24/06/2011,7232,7273,7099,7121,-89,115,-479,-453,-111,1,0,5
2926,27/06/2011,7101,7144,7079,7108,-132,-26,-25,-183,7,0,0,6
2927,28/06/2011,7138,7187,7075,7170,394,82,-11,465,32,0,1,6
2928,29/06/2011,7231,7320,7231,7294,183,57,114,354,63,0,1,7
2929,30/06/2011,7310,7378,7285,7376,147,63,58,268,66,0,1,7
2930,01/07/2011,7374,7443,7357,7419,497,103,118,718,45,0,1,7
2931,04/07/2011,7427,7450,7417,7443,224,67,-31,260,16,0,1,7
2932,05/07/2011,7433,7475,7425,7439,230,32,-58,204,6,0,1,8
2933,06/07/2011,7444,7451,7397,7431,-226,211,130,115,-13,0,0,8
2934,07/07/2011,7468,7516,7443,7471,-138,-39,-246,-423,3,0,0,7
2935,08/07/2011,7503,7524,7390,7403,159,-134,-159,-134,-100,1,0,7
2936,11/07/2011,7353,7358,7189,7230,267,-671,-354,-758,-123,1,0,7
2937,12/07/2011,7112,7190,6996,7174,65,-80,31,16,62,0,1,8
2938,13/07/2011,7171,7280,7163,7268,229,97,97,423,97,0,1,8
2939,14/07/2011,7205,7267,7197,7215,-140,57,235,152,10,0,1,8
2940,15/07/2011,7189,7254,7140,7220,4,-3,-131,-130,31,0,0,8
2941,18/07/2011,7163,7172,7089,7108,421,51,-57,415,-55,0,0,7
2942,19/07/2011,7148,7236,7140,7193,4,-459,33,-422,45,0,0,6
2943,20/07/2011,7250,7263,7166,7221,-120,-302,-126,-548,-29,1,0,5
2944,21/07/2011,7063,7063,7063,7063,-75,16,0,-59,0,0,0,6
2945,22/07/2011,7308,7357,7267,7326,122,-223,-72,-173,18,0,0,6
2946,25/07/2011,7274,7367,7259,7345,23,71,-83,11,71,0,1,5
2947,26/07/2011,7370,7383,7302,7349,-94,-21,163,48,-21,0,0,5
2948,27/07/2011,7316,7344,7217,7253,-54,54,-248,-248,-63,1,0,4
2949,28/07/2011,7164,7203,7110,7190,117,-77,-39,1,26,0,1,4
2950,29/07/2011,7108,7191,7064,7159,330,-86,43,287,51,0,1,4
2951,01/08/2011,7254,7282,6954,6954,-143,-128,-302,-573,-300,1,0,5
2952,02/08/2011,6909,6938,6772,6797,-203,-296,-352,-851,-112,1,0,6
2953,03/08/2011,6718,6783,6544,6641,-77,36,-77,-118,-77,1,0,7
2954,04/08/2011,6715,6730,6392,6415,-300,-523,-300,-1123,-300,1,0,7
2955,05/08/2011,6339,6437,6153,6236,-103,-103,-103,-309,-103,1,0,8
2956,08/08/2011,6171,6273,5911,5923,-248,-248,-248,-744,-248,1,0,9
2957,09/08/2011,5896,6026,5503,5917,21,468,21,510,21,0,1,9
2958,10/08/2011,6041,6089,5549,5613,-428,-428,-428,-1284,-428,1,0,10
2959,11/08/2011,5771,5825,5488,5798,27,468,27,522,27,0,1,10
2960,12/08/2011,5776,6024,5679,5998,222,222,222,666,222,0,1,10
2961,15/08/2011,6076,6106,6008,6022,-83,-162,102,-143,-54,1,0,10
2962,16/08/2011,5958,5998,5850,5995,12,-80,81,13,37,0,1,10
2963,17/08/2011,5910,6018,5870,5949,109,164,-165,108,39,0,1,10
2964,18/08/2011,5854,5893,5536,5603,-259,-58,-213,-530,-251,1,0,10
2965,19/08/2011,5582,5595,5345,5480,-130,251,-130,-9,-102,1,0,10
2966,22/08/2011,5413,5591,5409,5474,-24,365,484,825,61,0,1,10
2967,23/08/2011,5529,5636,5452,5532,3,333,3,339,3,0,1,10
2968,24/08/2011,5580,5743,5514,5681,341,287,368,996,101,0,1,10
2969,25/08/2011,5740,5777,5452,5584,-531,-865,-396,-1792,-156,1,0,10
2970,26/08/2011,5582,5589,5404,5537,214,-76,160,298,-45,0,0,10
2971,29/08/2011,5634,5715,5588,5670,214,71,20,305,36,0,1,9
2972,30/08/2011,5714,5730,5573,5644,374,221,-11,584,-70,0,0,9
2973,31/08/2011,5686,5870,5649,5785,213,232,223,668,99,0,1,8
2974,01/09/2011,5793,5794,5639,5731,194,-55,-280,-141,-62,1,0,8
2975,02/09/2011,5624,5636,5493,5538,-9,-29,163,125,-86,0,0,8
2976,05/09/2011,5410,5421,5208,5246,19,-17,-532,-530,-164,1,0,7
2977,06/09/2011,5248,5332,5150,5194,-54,365,-54,257,-54,0,0,7
2978,07/09/2011,5333,5406,5277,5406,73,154,73,300,73,0,1,6
2979,08/09/2011,5410,5474,5314,5408,78,-166,81,-7,-2,1,0,6
2980,09/09/2011,5384,5401,5174,5190,-625,-792,-432,-1849,-194,1,0,6
2981,12/09/2011,5064,5127,4966,5072,8,327,8,343,8,0,1,7
2982,13/09/2011,5154,5223,4970,5166,295,365,295,955,12,0,1,7
2983,14/09/2011,5108,5348,5106,5340,326,320,682,1328,232,0,1,8
2984,15/09/2011,5387,5567,5375,5508,362,918,243,1523,121,0,1,8
2985,16/09/2011,5608,5656,5524,5574,-34,-78,-140,-252,-34,1,0,8
2986,19/09/2011,5447,5497,5362,5416,-31,-60,-31,-122,-31,1,0,9
2987,20/09/2011,5374,5578,5369,5572,54,78,-55,77,198,0,1,9
2988,21/09/2011,5557,5558,5418,5434,-94,-219,-140,-453,-123,1,0,10
2989,22/09/2011,5258,5290,5136,5164,1,-136,-223,-358,-94,1,0,10
2990,23/09/2011,5227,5230,4974,5197,-179,-30,114,-95,-30,1,0,10
2991,26/09/2011,5129,5416,5118,5346,310,217,85,612,217,0,1,10
2992,27/09/2011,5503,5638,5483,5628,261,77,132,470,125,0,1,10
2993,28/09/2011,5561,5700,5521,5578,122,-58,-140,-76,17,0,0,10
2994,29/09/2011,5555,5704,5533,5640,404,200,87,691,85,0,1,9
2995,30/09/2011,5603,5607,5439,5502,194,-18,-157,19,-101,0,0,9
2996,03/10/2011,5312,5438,5289,5377,-266,99,-97,-264,65,0,0,8
2997,04/10/2011,5284,5289,5125,5217,9,-237,225,-3,-67,1,0,7
2998,05/10/2011,5341,5486,5266,5473,229,178,132,539,132,0,1,7
2999,06/10/2011,5512,5645,5466,5645,-199,151,-142,-190,133,0,0,7
3000,07/10/2011,5648,5749,5606,5676,146,65,90,301,28,0,1,6
3001,10/10/2011,5705,5872,5653,5847,712,111,36,859,142,0,1,6
3002,11/10/2011,5826,5883,5774,5865,46,39,39,124,39,0,1,6
3003,12/10/2011,5851,6022,5798,5994,46,143,143,332,143,0,1,6
3004,13/10/2011,5970,6036,5878,5915,-56,-55,-55,-166,-55,1,0,7
3005,14/10/2011,5935,6037,5885,5967,-144,-51,-226,-421,32,0,0,7
3006,17/10/2011,6021,6081,5820,5859,-162,-162,-130,-454,-162,1,0,7
3007,18/10/2011,5782,5907,5748,5877,141,7,96,244,95,0,1,8
3008,19/10/2011,5910,5978,5875,5914,-91,-256,121,-226,4,0,0,8
3009,20/10/2011,5834,5915,5753,5766,-78,197,175,294,-68,0,0,7
3010,21/10/2011,5800,5980,5769,5971,616,639,280,1535,171,0,1,7
3011,24/10/2011,6014,6067,5938,6055,34,388,-388,34,41,0,1,7
3012,25/10/2011,6026,6158,5964,6047,-77,39,-116,-154,21,0,0,7
3013,26/10/2011,6041,6144,5952,6016,-87,63,71,47,-25,0,0,6
3014,27/10/2011,6223,6348,6197,6338,412,183,213,808,115,0,1,5
3015,28/10/2011,6364,6431,6306,6346,9,-18,-18,-27,-18,1,0,5
3016,31/10/2011,6283,6305,6141,6141,-104,-142,-142,-388,-142,1,0,6
3017,01/11/2011,5935,5948,5762,5835,-273,-213,113,-373,-100,1,0,6
3018,02/11/2011,5897,5991,5811,5966,69,292,69,430,69,0,1,6
3019,03/11/2011,5835,6193,5832,6133,348,52,215,615,298,0,1,7
3020,04/11/2011,6175,6175,5929,5966,-234,-671,144,-761,-209,1,0,8
3021,07/11/2011,5906,6029,5835,5929,336,537,214,1087,23,0,1,8
3022,08/11/2011,5950,6087,5934,5961,22,-201,18,-161,11,0,0,8
3023,09/11/2011,6046,6056,5767,5830,-128,-41,-222,-391,-216,1,0,8
3024,10/11/2011,5732,5934,5722,5868,139,-35,136,240,136,0,1,9
3025,11/11/2011,5881,6065,5855,6057,138,170,97,405,176,0,1,9
3026,14/11/2011,6097,6116,5934,5985,-93,-204,-39,-336,-112,1,0,9
3027,15/11/2011,5920,6011,5816,5933,151,-124,-105,-78,13,0,0,9
3028,16/11/2011,5873,6028,5852,5913,-138,197,-71,-12,40,0,0,8
3029,17/11/2011,5876,5921,5778,5850,-6,-18,7,-17,-26,1,0,7
3030,18/11/2011,5801,5898,5770,5800,-70,105,314,349,-1,0,0,7
3031,21/11/2011,5767,5772,5598,5606,-133,-340,-404,-877,-161,1,0,6
3032,22/11/2011,5648,5682,5537,5537,22,603,22,647,-111,0,0,6
3033,23/11/2011,5486,5588,5458,5458,-130,68,-130,-192,-28,1,0,6
3034,24/11/2011,5513,5564,5400,5428,-109,82,399,372,-85,0,0,6
3035,25/11/2011,5433,5529,5366,5493,231,-513,139,-143,60,0,0,5
3036,28/11/2011,5577,5755,5573,5745,431,320,682,1433,168,0,1,4
3037,29/11/2011,5726,5826,5691,5800,216,99,74,389,74,0,1,4
3038,30/11/2011,5741,6131,5726,6089,475,348,348,1171,348,0,1,5
3039,01/12/2011,6080,6112,6017,6036,-44,-44,-44,-132,-44,1,0,6
3040,02/12/2011,6118,6170,6055,6081,-37,-37,-37,-111,-37,1,0,6
3041,05/12/2011,6138,6170,6086,6106,-32,-32,-32,-96,-32,1,0,7
3042,06/12/2011,6022,6095,6006,6029,-112,7,7,-98,7,0,0,7
3043,07/12/2011,6116,6137,5920,5995,-112,-39,-50,-201,-121,1,0,7
3044,08/12/2011,6055,6077,5869,5874,-457,-302,-184,-943,-181,1,0,7
3045,09/12/2011,5806,6007,5802,5987,7,102,48,157,181,0,1,8
3046,12/12/2011,5945,5953,5785,5785,-175,-401,-303,-879,-160,1,0,9
3047,13/12/2011,5801,5852,5734,5774,60,-27,-277,-244,-27,1,0,9
3048,14/12/2011,5739,5772,5675,5675,11,-64,-547,-600,-64,1,0,9
3049,15/12/2011,5713,5796,5682,5731,-181,18,18,-145,18,0,0,9
3050,16/12/2011,5764,5775,5693,5702,-52,-62,176,62,-62,0,0,8
3051,19/12/2011,5652,5775,5644,5671,-15,19,190,194,19,0,1,7
3052,20/12/2011,5653,5848,5638,5847,128,128,260,516,194,0,1,7
3053,21/12/2011,5919,5965,5772,5792,-118,-67,-69,-254,-127,1,0,8
3054,22/12/2011,5830,5886,5820,5852,-115,94,-303,-324,22,0,0,8
3055,23/12/2011,5905,5913,5845,5879,76,281,113,470,-26,0,0,7
3056,27/12/2011,5901,5924,5878,5890,38,-378,-111,-451,-11,1,0,6
3057,28/12/2011,5876,5901,5771,5771,-31,-155,-522,-708,-105,1,0,6
3058,29/12/2011,5804,5849,5776,5849,-192,280,-108,-20,45,0,0,6
3059,30/12/2011,5867,5898,5818,5898,184,-62,21,143,31,0,1,5
3060,03/01/2012,6124,6179,6109,6167,-85,194,-38,71,43,0,1,6
3061,04/01/2012,6141,6163,6088,6112,-4,-29,-29,-62,-29,1,0,7
3062,05/01/2012,6121,6130,6041,6096,-112,-147,-43,-302,-25,1,0,7
3063,06/01/2012,6115,6153,6013,6058,-73,-134,32,-175,-57,1,0,7
3064,09/01/2012,6061,6077,5988,6017,-286,-82,-52,-420,-44,1,0,7
3065,10/01/2012,6091,6191,6069,6163,-444,-194,79,-559,72,0,0,8
3066,11/01/2012,6148,6182,6106,6152,4,-128,-19,-143,4,0,0,8
3067,12/01/2012,6160,6257,6149,6179,64,-70,116,110,19,0,1,7
3068,13/01/2012,6242,6245,6064,6143,18,232,124,374,-99,0,0,7
3069,16/01/2012,6120,6232,6104,6220,95,96,125,316,100,0,1,7
3070,17/01/2012,6302,6343,6271,6333,-93,-245,-91,-429,31,0,0,7
3071,18/01/2012,6330,6399,6281,6355,277,-70,3,210,25,0,1,6
3072,19/01/2012,6377,6420,6334,6416,102,-130,-130,-158,39,0,0,6
3073,20/01/2012,6411,6431,6372,6404,112,-126,-126,-140,-7,1,0,5
3074,23/01/2012,6387,6467,6350,6437,-306,103,-120,-323,50,0,0,5
3075,24/01/2012,6372,6420,6339,6419,150,-16,20,154,47,0,1,4
3076,25/01/2012,6449,6457,6367,6422,-37,87,153,203,-27,0,0,5
3077,26/01/2012,6454,6559,6430,6540,572,-362,183,393,86,0,1,5
3078,27/01/2012,6508,6574,6484,6512,407,-92,-92,223,4,0,1,5
3079,30/01/2012,6455,6492,6414,6444,-49,28,-61,-82,-11,1,0,6
3080,31/01/2012,6489,6533,6450,6459,-371,-93,-281,-745,-30,1,0,6
3081,01/02/2012,6483,6630,6483,6617,189,22,87,298,134,0,1,7
3082,02/02/2012,6640,6668,6606,6656,-180,64,30,-86,16,0,0,7
3083,03/02/2012,6650,6767,6636,6767,350,125,97,572,117,0,1,7
3084,06/02/2012,6752,6781,6715,6765,24,102,76,202,13,0,1,7
3085,07/02/2012,6773,6789,6683,6754,-112,-98,49,-161,-19,1,0,8
3086,08/02/2012,6801,6830,6736,6749,-73,82,-175,-166,-52,1,0,8
3087,09/02/2012,6782,6838,6746,6789,-31,-83,145,31,7,0,1,9
3088,10/02/2012,6731,6751,6650,6693,102,-159,-170,-227,-38,1,0,9
3089,13/02/2012,6749,6775,6710,6738,-265,35,-24,-254,-11,1,0,9
3090,14/02/2012,6713,6789,6698,6728,-96,-70,-84,-250,15,0,0,9
3091,15/02/2012,6808,6830,6737,6758,253,-21,-74,158,-50,0,0,8
3092,16/02/2012,6665,6752,6652,6752,-105,-176,-35,-316,87,0,0,7
3093,17/02/2012,6811,6875,6795,6848,147,-165,251,233,37,0,1,7
3094,20/02/2012,6892,6957,6878,6948,-218,454,149,385,56,0,1,7
3095,21/02/2012,6937,6971,6874,6908,611,277,189,1077,-29,0,0,7
3096,22/02/2012,6915,6915,6822,6844,-231,-336,-249,-816,-71,1,0,6
3097,23/02/2012,6839,6904,6734,6809,-39,-119,-50,-208,-30,1,0,6
3098,24/02/2012,6871,6891,6826,6864,236,265,17,518,-7,0,0,6
3099,27/02/2012,6817,6869,6744,6850,-365,141,116,-108,33,0,0,5
3100,28/02/2012,6867,6901,6809,6888,165,-176,98,87,21,0,1,4
3101,29/02/2012,6915,6967,6843,6856,-59,-101,-252,-412,-59,1,0,5
3102,01/03/2012,6832,6949,6818,6942,131,-254,-32,-155,110,0,0,6
3103,02/03/2012,6944,6955,6904,6921,-59,-139,-56,-254,-23,1,0,6
3104,05/03/2012,6877,6903,6815,6866,257,-315,29,-29,-11,1,0,6
3105,06/03/2012,6836,6840,6633,6633,-63,-273,-40,-376,-203,1,0,6
3106,07/03/2012,6638,6683,6613,6671,163,-222,163,104,33,0,1,7
3107,08/03/2012,6723,6838,6704,6835,-72,336,59,323,112,0,1,7
3108,09/03/2012,6849,6912,6831,6880,-82,-74,71,-85,31,0,0,7
3109,12/03/2012,6869,6911,6847,6901,13,111,-213,-89,32,0,0,7
3110,13/03/2012,6957,7020,6942,6996,7,-265,-314,-572,39,0,0,7
3111,14/03/2012,7029,7099,7028,7079,-134,138,68,72,50,0,1,6
3112,15/03/2012,7094,7153,7072,7144,-105,-219,-38,-362,50,0,0,6
3113,16/03/2012,7146,7194,7143,7158,-450,-92,-153,-695,12,0,0,6
3114,19/03/2012,7144,7155,7095,7154,42,22,22,86,10,0,1,5
3115,20/03/2012,7122,7125,7032,7055,-105,-17,-67,-189,-67,1,0,5
3116,21/03/2012,7089,7114,7012,7071,-102,-46,-209,-357,-18,1,0,5
3117,22/03/2012,7053,7071,6938,6981,27,-225,-137,-335,-72,1,0,5
3118,23/03/2012,6987,7027,6909,6996,-3,24,-68,-47,9,0,0,5
3119,26/03/2012,7023,7102,6970,7079,220,208,-124,304,56,0,1,5
3120,27/03/2012,7107,7154,7075,7079,8,95,63,166,-28,0,0,6
3121,28/03/2012,7056,7111,6999,6999,131,47,-27,151,-57,0,0,6
3122,29/03/2012,6980,6994,6842,6875,28,-49,-5,-26,-105,1,0,5
3123,30/03/2012,6925,6960,6899,6947,-153,275,22,144,22,0,1,6
3124,02/04/2012,6974,7057,6912,7057,76,281,67,424,83,0,1,7
3125,03/04/2012,7054,7081,6981,6982,-118,212,-137,-43,-72,1,0,7
3126,04/04/2012,6941,6944,6773,6784,-11,-808,64,-755,-157,1,0,7
3127,05/04/2012,6818,6831,6686,6775,39,-11,-509,-481,-43,1,0,7
3128,10/04/2012,6695,6738,6606,6606,-63,-405,73,-395,-89,1,0,7
3129,11/04/2012,6629,6723,6603,6675,46,314,46,406,46,0,1,8
3130,12/04/2012,6710,6762,6652,6743,-20,508,33,521,33,0,1,8
3131,13/04/2012,6732,6743,6552,6584,-281,-792,-138,-1211,-148,1,0,9
3132,16/04/2012,6556,6675,6548,6625,-76,-89,10,-155,69,0,0,10
3133,17/04/2012,6626,6801,6617,6801,336,379,584,1299,175,0,1,9
3134,18/04/2012,6780,6813,6718,6732,287,-38,-48,201,-48,0,0,9
3135,19/04/2012,6775,6807,6665,6671,-218,34,-47,-231,-104,1,0,8
3136,20/04/2012,6690,6760,6652,6750,123,348,-129,342,60,0,1,8
3137,23/04/2012,6667,6668,6499,6523,-328,-547,-153,-1028,-144,1,0,8
3138,24/04/2012,6566,6605,6508,6590,163,-181,160,142,24,0,1,8
3139,25/04/2012,6623,6733,6623,6704,-263,-230,-24,-517,81,0,0,8
3140,26/04/2012,6703,6751,6642,6740,2,141,177,320,37,0,1,7
3141,27/04/2012,6662,6825,6653,6801,27,335,111,473,139,0,1,7
3142,30/04/2012,6844,6847,6760,6761,-573,-43,-43,-659,-83,1,0,7
3143,02/05/2012,6861,6876,6665,6711,-257,-547,-33,-837,-150,1,0,8
3144,03/05/2012,6749,6792,6648,6694,33,147,-115,65,-55,0,0,8
3145,04/05/2012,6683,6685,6546,6561,-122,-59,-128,-309,-122,1,0,8
3146,07/05/2012,6516,6579,6410,6569,-697,-147,-149,-993,53,0,0,8
3147,08/05/2012,6549,6577,6415,6445,-149,-54,-104,-307,-104,1,0,7
3148,09/05/2012,6483,6506,6376,6475,6,-219,-500,-713,-8,1,0,7
3149,10/05/2012,6531,6550,6440,6518,91,-45,-127,-81,-13,1,0,7
3150,11/05/2012,6465,6589,6454,6580,-80,-792,-17,-889,115,0,0,8
3151,14/05/2012,6500,6521,6404,6452,124,-615,25,-466,-48,1,0,7
3152,15/05/2012,6502,6510,6353,6401,-216,57,-128,-287,-101,1,0,7
3153,16/05/2012,6345,6443,6297,6384,-71,619,76,624,39,0,1,7
3154,17/05/2012,6401,6413,6291,6309,5,-798,-149,-942,-92,1,0,7
3155,18/05/2012,6255,6336,6229,6271,67,-452,248,-137,16,0,0,8
3156,21/05/2012,6269,6364,6244,6331,166,221,62,449,62,0,1,7
3157,22/05/2012,6382,6446,6351,6436,-117,100,306,289,54,0,1,8
3158,23/05/2012,6352,6374,6259,6286,35,933,165,1133,-66,0,0,8
3159,24/05/2012,6338,6351,6244,6316,-252,-19,-114,-385,-22,1,0,7
3160,25/05/2012,6334,6407,6280,6340,31,164,79,274,6,0,1,7
3161,28/05/2012,6425,6426,6311,6323,116,-96,-114,-94,-102,1,0,8
3162,29/05/2012,6397,6441,6335,6397,-279,138,13,-128,0,0,0,8
3163,30/05/2012,6361,6392,6259,6281,-50,-246,-28,-324,-80,1,0,7
3164,31/05/2012,6298,6323,6208,6264,17,-246,-141,-370,-34,1,0,7
3165,01/06/2012,6260,6260,6008,6050,-250,-581,-210,-1041,-210,1,0,7
3166,04/06/2012,5976,6031,5942,5978,2,-317,2,-313,2,0,0,8
3167,05/06/2012,6000,6012,5914,5969,102,382,172,656,-31,0,0,7
3168,06/06/2012,6028,6102,5996,6094,-203,-296,-352,-851,66,0,0,6
3169,07/06/2012,6118,6230,6099,6144,-625,-260,1,-884,26,0,0,6
3170,08/06/2012,6083,6145,6054,6131,57,-2,-127,-72,48,0,0,5
3171,11/06/2012,6256,6288,6130,6141,120,-615,-5,-500,-115,1,0,4
3172,12/06/2012,6142,6211,6084,6161,-8,210,136,338,19,0,1,4
3173,13/06/2012,6184,6221,6094,6152,-207,-406,-236,-849,-32,1,0,5
3174,14/06/2012,6147,6167,6078,6139,-164,-269,-35,-468,-8,1,0,5
3175,15/06/2012,6165,6252,6159,6229,365,447,-35,777,64,0,1,5
3176,18/06/2012,6305,6316,6222,6248,244,-201,-183,-140,-57,1,0,5
3177,19/06/2012,6255,6375,6233,6363,-91,-201,-333,-625,108,0,0,6
3178,20/06/2012,6364,6402,6334,6392,265,-36,28,257,28,0,1,6
3179,21/06/2012,6357,6427,6332,6343,-14,-49,-14,-77,-14,1,0,7
3180,22/06/2012,6273,6318,6256,6263,-406,151,83,-172,-10,1,0,8
3181,25/06/2012,6229,6229,6119,6132,-109,-131,-174,-414,-97,1,0,9
3182,26/06/2012,6158,6165,6110,6137,150,51,-43,158,-21,0,0,9
3183,27/06/2012,6156,6231,6131,6229,193,73,8,274,73,0,1,8
3184,28/06/2012,6232,6240,6097,6150,-229,-22,-55,-306,-82,1,0,8
3185,29/06/2012,6297,6416,6262,6416,312,85,206,603,119,0,1,8
3186,02/07/2012,6405,6520,6391,6496,-399,35,-55,-419,91,0,0,8
3187,03/07/2012,6508,6578,6505,6578,60,67,49,176,70,0,1,7
3188,04/07/2012,6564,6574,6526,6565,-317,1,1,-315,1,0,0,8
3189,05/07/2012,6562,6642,6476,6536,19,33,81,133,-26,0,0,7
3190,06/07/2012,6508,6534,6408,6410,34,-70,-31,-67,-98,1,0,6
3191,09/07/2012,6409,6421,6376,6388,70,-341,229,-42,-21,1,0,6
3192,10/07/2012,6397,6491,6350,6438,302,80,-112,270,41,0,1,6
3193,11/07/2012,6413,6497,6399,6454,241,-301,51,-9,41,0,0,7
3194,12/07/2012,6411,6448,6367,6419,18,361,26,405,8,0,1,6
3195,13/07/2012,6446,6557,6436,6557,-105,167,148,210,111,0,1,6
3196,16/07/2012,6551,6577,6511,6566,-59,178,66,185,15,0,1,6
3197,17/07/2012,6584,6611,6543,6578,192,158,112,462,-6,0,0,7
3198,18/07/2012,6602,6691,6579,6684,68,-204,116,-20,82,0,0,6
3199,19/07/2012,6707,6774,6699,6758,35,60,-38,57,51,0,1,6
3200,20/07/2012,6742,6776,6621,6630,314,-178,-178,-42,-112,1,0,7
3201,23/07/2012,6562,6572,6371,6419,-12,-26,-4,-42,-143,1,0,7
3202,24/07/2012,6421,6456,6378,6390,199,166,31,396,-31,0,0,7
3203,25/07/2012,6388,6475,6375,6407,17,-220,-7,-210,19,0,0,6
3204,26/07/2012,6393,6596,6325,6583,158,261,190,609,190,0,1,6
3205,27/07/2012,6605,6690,6514,6689,75,110,51,236,84,0,1,6
3206,30/07/2012,6729,6797,6703,6774,64,104,23,191,45,0,1,6
3207,31/07/2012,6781,6835,6756,6772,102,-141,-53,-92,-9,1,0,6
3208,01/08/2012,6776,6800,6736,6754,-206,145,-175,-236,-22,1,0,7
3209,02/08/2012,6756,6856,6596,6606,-138,-166,131,-173,-150,1,0,8
3210,03/08/2012,6626,6877,6621,6866,238,117,137,492,240,0,1,8
3211,06/08/2012,6846,6943,6846,6919,24,102,76,202,73,0,1,8
3212,07/08/2012,6909,6980,6903,6968,126,33,59,218,59,0,1,8
3213,08/08/2012,6945,6966,6907,6966,144,120,120,384,21,0,1,9
3214,09/08/2012,6979,6989,6891,6965,120,-112,-40,-32,-14,1,0,10
3215,10/08/2012,6928,6955,6892,6945,-138,200,-4,58,17,0,1,10
3216,13/08/2012,6936,6976,6882,6910,-65,-6,-57,-128,-26,1,0,10
3217,14/08/2012,6965,6995,6940,6974,-444,-109,126,-427,9,0,0,10
3218,15/08/2012,6953,6973,6910,6947,68,-330,-602,-864,-6,1,0,9
3219,16/08/2012,6958,7001,6929,6996,-137,15,17,-105,38,0,0,9
3220,17/08/2012,7011,7041,7001,7041,-303,72,93,-138,30,0,0,8
3221,20/08/2012,7037,7086,7009,7034,66,2,-138,-70,-3,1,0,7
3222,21/08/2012,7049,7105,7042,7089,-320,197,36,-87,40,0,0,7
3223,22/08/2012,7048,7052,7005,7018,-382,102,3,-277,-30,1,0,6
3224,23/08/2012,7066,7081,6923,6950,-399,110,-2,-291,-116,1,0,6
3225,24/08/2012,6958,6990,6886,6971,-191,-224,-123,-538,13,0,0,6
3226,27/08/2012,6960,7049,6946,7047,-39,-32,-58,-129,87,0,0,5
3227,28/08/2012,7004,7031,6976,7003,-402,30,-163,-535,-1,1,0,4
3228,29/08/2012,7003,7030,6946,7011,-95,171,347,423,8,0,1,5
3229,30/08/2012,6962,6978,6871,6895,-178,-237,188,-227,-67,1,0,5
3230,31/08/2012,6898,7011,6890,6971,-26,648,246,868,73,0,1,6
3231,03/09/2012,6947,7016,6944,7015,-153,-331,130,-354,68,0,0,7
3232,04/09/2012,7013,7016,6920,6933,-174,933,-88,671,-80,0,0,6
3233,05/09/2012,6942,7004,6893,6965,161,260,36,457,23,0,1,6
3234,06/09/2012,6984,7172,6978,7167,201,113,151,465,183,0,1,6
3235,07/09/2012,7184,7249,7183,7214,507,85,-95,497,30,0,1,6
3236,10/09/2012,7208,7234,7204,7214,-87,46,6,-35,6,0,0,7
3237,11/09/2012,7197,7313,7187,7310,383,163,122,668,113,0,1,7
3238,12/09/2012,7332,7410,7307,7344,24,-36,-36,-48,12,0,0,7
3239,13/09/2012,7342,7353,7280,7310,76,-54,-54,-32,-32,1,0,6
3240,14/09/2012,7398,7446,7389,7412,-306,110,32,-164,14,0,0,6
3241,17/09/2012,7390,7414,7382,7404,193,70,-3,260,14,0,1,5
3242,18/09/2012,7350,7375,7304,7348,183,14,113,310,-2,0,0,6
3243,19/09/2012,7387,7396,7326,7391,382,-353,320,349,4,0,1,6
3244,20/09/2012,7323,7390,7313,7389,71,98,320,489,66,0,1,6
3245,21/09/2012,7409,7479,7391,7452,-267,-119,-56,-442,43,0,0,6
3246,24/09/2012,7420,7440,7388,7413,-225,-261,55,-431,-7,1,0,5
3247,25/09/2012,7406,7439,7369,7425,-24,-185,31,-178,19,0,0,6
3248,26/09/2012,7363,7363,7256,7277,202,-17,31,216,-86,0,0,5
3249,27/09/2012,7313,7325,7269,7290,7,340,58,405,-23,0,0,5
3250,28/09/2012,7331,7337,7216,7216,-211,186,4,-21,-115,1,0,4
3251,01/10/2012,7228,7339,7225,7327,-127,169,87,129,99,0,1,5
3252,02/10/2012,7278,7373,7266,7306,-167,103,-165,-229,28,0,0,5
3253,03/10/2012,7283,7339,7272,7322,81,-41,-155,-115,39,0,0,5
3254,04/10/2012,7368,7375,7283,7305,-334,-461,81,-714,-63,1,0,4
3255,05/10/2012,7328,7410,7313,7398,11,-331,15,-305,70,0,0,4
3256,08/10/2012,7340,7341,7286,7291,169,-199,42,12,-49,0,0,4
3257,09/10/2012,7306,7308,7222,7235,-76,-808,32,-852,-71,1,0,3
3258,10/10/2012,7219,7245,7201,7205,48,-29,-64,-45,-14,1,0,4
3259,11/10/2012,7193,7305,7182,7282,127,713,103,943,89,0,1,5
3260,12/10/2012,7261,7291,7232,7232,148,142,-62,228,-29,0,0,6
3261,15/10/2012,7237,7302,7237,7261,155,93,-207,41,24,0,1,5
3262,16/10/2012,7309,7388,7294,7376,-143,-601,61,-683,67,0,0,5
3263,17/10/2012,7381,7400,7368,7395,-241,-302,70,-473,14,0,0,5
3264,18/10/2012,7401,7448,7389,7437,-246,8,21,-217,36,0,0,5
3265,19/10/2012,7414,7430,7364,7381,31,-324,14,-279,-33,1,0,4
3266,22/10/2012,7372,7390,7313,7328,179,128,162,469,-44,0,0,5
3267,23/10/2012,7339,7344,7154,7174,-209,-187,13,-383,-165,1,0,5
3268,24/10/2012,7202,7216,7121,7193,-66,-60,-31,-157,-9,1,0,5
3269,25/10/2012,7203,7256,7181,7200,-3,-247,-3,-253,-3,1,0,5
3270,26/10/2012,7162,7257,7148,7232,-136,-602,114,-624,70,0,0,5
3271,29/10/2012,7205,7225,7172,7203,169,-45,-30,94,-2,0,0,5
3272,30/10/2012,7240,7293,7239,7284,98,50,114,262,44,0,1,4
3273,31/10/2012,7305,7348,7261,7261,-210,115,80,-15,-44,1,0,5
3274,01/11/2012,7255,7356,7255,7336,526,328,69,923,81,0,1,6
3275,02/11/2012,7337,7391,7315,7364,51,267,46,364,27,0,1,7
3276,05/11/2012,7321,7337,7304,7326,-22,-345,-187,-554,5,0,0,7
3277,06/11/2012,7336,7389,7320,7378,48,-156,57,-51,42,0,0,7
3278,07/11/2012,7425,7435,7227,7233,-418,-272,-187,-877,-192,1,0,6
3279,08/11/2012,7260,7287,7184,7205,-440,97,-64,-407,-55,1,0,6
3280,09/11/2012,7221,7223,7064,7164,-39,121,-57,25,-57,0,0,6
3281,12/11/2012,7165,7196,7138,7169,82,-374,-432,-724,4,0,0,6
3282,13/11/2012,7132,7185,7075,7169,-303,-154,-432,-889,37,0,0,6
3283,14/11/2012,7156,7183,7085,7102,102,-102,-66,-66,-54,1,0,5
3284,15/11/2012,7065,7079,7022,7043,-213,358,12,157,-22,0,0,5
3285,16/11/2012,7046,7060,6951,6951,182,24,124,330,-95,0,0,4
3286,19/11/2012,7020,7131,7007,7124,73,123,76,272,104,0,1,3
3287,20/11/2012,7098,7187,7092,7173,40,41,132,213,75,0,1,4
3288,21/11/2012,7149,7195,7140,7185,-82,-38,-138,-258,36,0,0,5
3289,22/11/2012,7210,7253,7205,7245,191,242,-70,363,35,0,1,4
3290,23/11/2012,7258,7312,7220,7309,43,-134,240,149,51,0,1,4
3291,26/11/2012,7287,7313,7274,7292,5,45,-132,-82,5,0,0,5
3292,27/11/2012,7343,7362,7307,7332,103,-361,75,-183,-11,1,0,5
3293,28/11/2012,7317,7351,7265,7343,-90,-127,-132,-349,26,0,0,6
3294,29/11/2012,7383,7417,7377,7401,-5,6,98,99,18,0,1,5
3295,30/11/2012,7399,7443,7398,7406,350,-16,32,366,7,0,1,6
3296,03/12/2012,7427,7488,7419,7435,417,197,8,622,8,0,1,7
3297,04/12/2012,7428,7466,7417,7435,697,54,-84,667,7,0,1,7
3298,05/12/2012,7481,7482,7429,7455,-384,-112,-115,-611,-26,1,0,7
3299,06/12/2012,7470,7555,7461,7535,-220,79,59,-82,65,0,0,8
3300,07/12/2012,7540,7553,7488,7518,63,-38,-44,-19,-22,1,0,7
3301,10/12/2012,7485,7537,7457,7531,-212,22,-74,-264,46,0,0,7
3302,11/12/2012,7529,7597,7519,7590,333,-140,-54,139,61,0,1,7
3303,12/12/2012,7595,7626,7590,7615,417,107,69,593,20,0,1,7
3304,13/12/2012,7619,7619,7562,7582,697,-83,-139,475,-37,0,0,8
3305,14/12/2012,7599,7619,7571,7596,222,-35,110,297,-3,0,0,7
3306,17/12/2012,7604,7627,7564,7605,-217,-65,68,-214,1,0,0,6
3307,18/12/2012,7634,7668,7626,7654,196,-610,-214,-628,20,0,0,5
3308,19/12/2012,7675,7683,7656,7668,-39,405,144,510,-7,0,0,4
3309,20/12/2012,7643,7675,7635,7672,31,447,141,619,29,0,1,3
3310,21/12/2012,7632,7654,7597,7636,-220,168,-130,-182,4,0,0,4
3311,24/12/2012,7636,7636,7636,7636,-92,128,-331,-295,0,0,0,3
3312,26/12/2012,7636,7636,7636,7636,-30,89,110,169,0,0,0,3
3313,27/12/2012,7652,7676,7640,7656,236,-63,-90,83,4,0,1,2
3314,28/12/2012,7650,7666,7603,7612,-285,221,47,-17,-38,1,0,2
3315,31/12/2012,7612,7612,7612,7612,-90,-808,-99,-997,0,0,0,3
3316,02/01/2013,7689,7790,7689,7779,-193,-539,-277,-1009,90,0,0,3
3317,03/01/2013,7762,7777,7738,7756,697,-69,-214,414,-6,0,0,3
3318,04/01/2013,7741,7780,7728,7776,-382,571,-127,62,35,0,1,3
3319,07/01/2013,7760,7768,7713,7733,-176,12,-195,-359,-27,1,0,4
3320,08/01/2013,7711,7754,7683,7696,75,87,181,343,-15,0,0,4
3321,09/01/2013,7714,7735,7689,7720,13,-58,-24,-69,6,0,0,4
3322,10/01/2013,7732,7774,7685,7708,117,221,80,418,-24,0,0,4
3323,11/01/2013,7726,7731,7684,7716,-123,347,-122,102,-10,0,0,4
3324,14/01/2013,7738,7786,7702,7730,212,-18,-89,105,-8,0,0,3
3325,15/01/2013,7704,7735,7636,7676,-140,-58,-32,-230,-28,1,0,2
3326,16/01/2013,7662,7695,7643,7691,-68,-176,29,-215,29,0,0,3
3327,17/01/2013,7677,7764,7662,7735,6,-457,258,-193,58,0,0,3
3328,18/01/2013,7747,7753,7702,7702,2,267,-45,224,-45,0,0,3
3329,21/01/2013,7728,7750,7719,7749,-55,94,73,112,21,0,1,2
3330,22/01/2013,7742,7747,7634,7696,-129,5,65,-59,-46,1,0,2
3331,23/01/2013,7703,7732,7685,7708,-177,50,26,-101,5,0,0,3
3332,24/01/2013,7701,7753,7662,7748,15,-169,68,-86,47,0,0,3
3333,25/01/2013,7747,7865,7743,7858,138,-182,65,21,111,0,1,3
3334,28/01/2013,7860,7872,7832,7833,557,-130,-230,197,-27,0,0,4
3335,29/01/2013,7842,7857,7800,7849,-319,-213,113,-419,7,0,0,4
3336,30/01/2013,7856,7863,7775,7811,333,299,-30,602,-45,0,0,3
3337,31/01/2013,7800,7812,7765,7776,-113,27,-76,-162,-24,1,0,3
3338,01/02/2013,7793,7853,7785,7833,233,327,-31,529,40,0,1,4
3339,04/02/2013,7823,7838,7638,7638,-182,-192,-239,-613,-185,1,0,5
3340,05/02/2013,7644,7677,7622,7665,20,90,71,181,21,0,1,5
3341,06/02/2013,7666,7694,7537,7581,-175,-260,-17,-452,-85,1,0,5
3342,07/02/2013,7581,7661,7565,7591,-52,23,114,85,10,0,1,6
3343,08/02/2013,7608,7655,7577,7652,33,379,169,581,44,0,1,7
3344,11/02/2013,7628,7677,7598,7634,83,-777,197,-497,6,0,0,7
3345,12/02/2013,7619,7662,7594,7660,-64,-45,120,11,41,0,1,7
3346,13/02/2013,7678,7737,7650,7712,-11,346,219,554,34,0,1,8
3347,14/02/2013,7698,7729,7607,7631,-129,-287,-40,-456,-67,1,0,9
3348,15/02/2013,7636,7650,7589,7594,-293,-461,132,-622,-42,1,0,9
3349,18/02/2013,7591,7630,7568,7629,108,-22,185,271,38,0,1,9
3350,19/02/2013,7614,7763,7612,7752,-101,115,85,99,138,0,1,9
3351,20/02/2013,7747,7785,7709,7729,-573,-194,237,-530,-18,1,0,9
3352,21/02/2013,7682,7688,7562,7584,59,-120,-216,-277,-98,1,0,9
3353,22/02/2013,7620,7681,7607,7662,68,12,211,291,42,0,1,9
3354,25/02/2013,7732,7861,7726,7773,21,327,252,600,41,0,1,9
3355,26/02/2013,7682,7684,7589,7597,-292,-86,-189,-567,-85,1,0,10
3356,27/02/2013,7642,7679,7566,7676,-622,41,-46,-627,34,0,0,10
3357,28/02/2013,7712,7753,7692,7742,-164,44,87,-33,30,0,0,9
3358,01/03/2013,7735,7768,7628,7708,53,29,57,139,-27,0,0,8
3359,04/03/2013,7655,7709,7637,7692,30,-302,112,-160,37,0,0,7
3360,05/03/2013,7780,7884,7772,7870,130,585,-129,586,90,0,1,6
3361,06/03/2013,7907,7978,7898,7919,447,111,36,594,12,0,1,6
3362,07/03/2013,7934,7956,7912,7940,38,-25,-7,6,6,0,1,6
3363,08/03/2013,7971,8015,7962,7986,71,-36,23,58,15,0,1,6
3364,11/03/2013,7967,7989,7955,7984,38,17,17,72,17,0,1,6
3365,12/03/2013,7971,8000,7934,7966,-89,-7,94,-2,-5,1,0,6
3366,13/03/2013,7965,7979,7942,7971,-270,66,-117,-321,6,0,0,6
3367,14/03/2013,8013,8060,8011,8058,-162,-29,133,-58,45,0,0,6
3368,15/03/2013,8074,8074,7997,8043,-399,-86,-48,-533,-31,1,0,6
3369,18/03/2013,7924,8021,7902,8011,-138,11,-423,-550,87,0,0,7
3370,19/03/2013,7981,8001,7919,7948,202,-185,65,82,-33,0,0,7
3371,20/03/2013,7996,8030,7972,8002,284,35,-75,244,6,0,1,6
3372,21/03/2013,7990,7999,7888,7933,-17,183,211,377,-57,0,0,6
3373,22/03/2013,7918,7954,7876,7911,308,87,421,816,-7,0,0,5
3374,25/03/2013,7988,8031,7848,7871,129,54,-183,0,-117,0,0,4
3375,26/03/2013,7889,7913,7859,7880,-384,594,-47,163,-9,0,0,3
3376,27/03/2013,7906,7917,7750,7789,98,52,-28,122,-117,0,0,2
3377,28/03/2013,7791,7843,7778,7795,52,-220,-77,-245,4,0,0,2
3378,01/04/2013,7795,7795,7795,7795,-216,111,-178,-283,0,0,0,2
3379,02/04/2013,7806,7949,7806,7944,106,727,235,1068,138,0,1,1
3380,03/04/2013,7927,7953,7870,7875,-25,-1023,6,-1042,-52,1,0,2
3381,04/04/2013,7903,7928,7804,7817,-127,210,140,223,-86,0,0,3
3382,05/04/2013,7821,7825,7632,7659,-436,-157,-278,-871,-162,1,0,2
3383,08/04/2013,7669,7698,7646,7663,124,-161,96,59,-6,0,0,3
3384,09/04/2013,7704,7723,7608,7638,-175,-284,-175,-634,-66,1,0,3
3385,10/04/2013,7664,7822,7660,7811,163,-181,160,142,147,0,1,4
3386,11/04/2013,7799,7885,7787,7872,-310,169,177,36,73,0,1,5
3387,12/04/2013,7832,7839,7726,7745,-623,-226,-61,-910,-87,1,0,6
3388,15/04/2013,7741,7773,7652,7713,-80,-628,-21,-729,-28,1,0,7
3389,16/04/2013,7681,7740,7639,7683,-250,164,-13,-99,2,0,0,8
3390,17/04/2013,7720,7722,7473,7503,-676,-344,-341,-1361,-217,1,0,7
3391,18/04/2013,7520,7557,7437,7474,160,-37,682,805,-46,0,0,7
3392,19/04/2013,7490,7531,7418,7460,543,248,314,1105,-30,0,0,7
3393,22/04/2013,7516,7538,7438,7478,-20,-79,132,33,-38,0,0,6
3394,23/04/2013,7477,7664,7442,7658,219,336,248,803,181,0,1,6
3395,24/04/2013,7657,7767,7656,7759,269,933,-189,1013,102,0,1,6
3396,25/04/2013,7767,7838,7742,7833,-33,93,13,73,66,0,1,6
3397,26/04/2013,7836,7840,7768,7815,-25,181,-57,99,-21,0,0,6
3398,29/04/2013,7834,7874,7823,7874,-154,-233,-206,-593,40,0,0,5
3399,30/04/2013,7928,7966,7893,7914,49,-107,-14,-72,-14,1,0,4
3400,01/05/2013,7914,7914,7914,7914,-139,51,40,-48,0,0,0,5
3401,02/05/2013,7905,8006,7897,7962,38,-15,83,106,57,0,1,4
3402,03/05/2013,7972,8130,7957,8122,66,244,150,460,150,0,1,5
3403,06/05/2013,8119,8148,8103,8112,46,-7,-7,32,-7,0,0,6
3404,07/05/2013,8126,8206,8117,8182,-28,-44,-39,-111,56,0,0,6
3405,08/05/2013,8177,8253,8173,8250,314,217,217,748,73,0,1,5
3406,09/05/2013,8232,8274,8225,8263,-438,107,52,-279,31,0,0,5
3407,10/05/2013,8278,8358,8252,8279,247,-2,1,246,1,0,1,4
3408,13/05/2013,8282,8295,8217,8279,-87,-141,-120,-348,-3,1,0,5
3409,14/05/2013,8304,8339,8236,8339,-212,83,111,-18,35,0,0,6
3410,15/05/2013,8334,8368,8300,8362,507,-95,-46,366,28,0,1,5
3411,16/05/2013,8349,8401,8324,8370,-255,35,-55,-275,21,0,0,6
3412,17/05/2013,8356,8409,8327,8398,191,-164,-210,-183,42,0,0,5
3413,20/05/2013,8435,8456,8402,8456,229,-457,-238,-466,21,0,0,4
3414,21/05/2013,8447,8476,8398,8472,102,81,227,410,25,0,1,4
3415,22/05/2013,8468,8558,8435,8531,417,-317,31,131,63,0,1,5
3416,23/05/2013,8410,8412,8281,8352,334,156,131,621,-58,0,0,5
3417,24/05/2013,8390,8391,8263,8305,-14,-84,-152,-250,-85,1,0,5
3418,27/05/2013,8347,8387,8338,8383,-63,52,-114,-125,36,0,0,5
3419,28/05/2013,8432,8526,8424,8481,34,-608,18,-556,49,0,0,4
3420,29/05/2013,8437,8445,8317,8337,-159,-199,-58,-416,-100,1,0,4
3421,30/05/2013,8314,8416,8294,8400,-57,421,136,500,86,0,1,4
3422,31/05/2013,8385,8402,8297,8349,-68,-507,127,-448,-36,1,0,5
3423,03/06/2013,8291,8396,8215,8286,-39,59,-102,-82,-5,1,0,6
3424,04/06/2013,8359,8384,8275,8296,278,560,-47,791,-63,0,0,7
3425,05/06/2013,8229,8293,8182,8196,-231,276,39,84,-33,0,0,6
3426,06/06/2013,8189,8235,8099,8099,281,425,87,793,-90,0,0,5
3427,07/06/2013,8125,8279,8035,8255,163,-222,163,104,130,0,1,5
3428,10/06/2013,8246,8356,8246,8308,-54,93,116,155,62,0,1,5
3429,11/06/2013,8256,8261,8141,8222,101,353,69,523,-34,0,0,6
3430,12/06/2013,8205,8246,8123,8143,-315,217,116,18,-62,0,0,6
3431,13/06/2013,8023,8110,7968,8095,-133,-92,90,-135,72,0,0,5
3432,14/06/2013,8158,8188,8111,8128,-89,-54,81,-62,-30,1,0,4
3433,17/06/2013,8171,8265,8168,8216,-13,-190,183,-20,45,0,0,4
3434,18/06/2013,8196,8242,8176,8230,-109,933,34,858,34,0,1,3
3435,19/06/2013,8255,8286,8160,8197,-61,120,-50,9,-58,0,0,4
3436,20/06/2013,8086,8086,7912,7928,57,-344,-135,-422,-158,1,0,4
3437,21/06/2013,7946,7987,7789,7789,-203,165,-352,-390,-157,1,0,5
3438,24/06/2013,7777,7824,7656,7692,-170,43,338,211,-85,0,0,5
3439,25/06/2013,7741,7842,7726,7811,70,31,70,171,70,0,1,4
3440,26/06/2013,7810,7960,7801,7941,400,221,619,1240,131,0,1,5
3441,27/06/2013,7946,8026,7920,7991,394,-182,126,338,45,0,1,6
3442,28/06/2013,8016,8038,7906,7959,-179,214,-47,-12,-57,1,0,7
3443,01/07/2013,8000,8023,7890,7984,-274,307,-12,21,-16,0,0,7
3444,02/07/2013,7989,7989,7874,7911,-4,48,-157,-113,-78,1,0,7
3445,03/07/2013,7841,7842,7730,7829,-189,328,-134,5,-12,0,0,7
3446,04/07/2013,7878,8015,7864,7994,-226,-29,-139,-394,116,0,0,7
3447,05/07/2013,8010,8032,7805,7806,-21,-87,-276,-384,-204,1,0,6
3448,08/07/2013,7866,8015,7848,7969,347,-20,103,430,103,0,1,6
3449,09/07/2013,8021,8087,8006,8058,134,-198,-26,-90,37,0,0,7
3450,10/07/2013,8057,8081,7991,8066,238,73,4,315,9,0,1,6
3451,11/07/2013,8164,8177,8130,8159,-60,58,4,2,-5,0,0,6
3452,12/07/2013,8193,8244,8178,8213,23,-18,-53,-48,20,0,0,5
3453,15/07/2013,8238,8271,8211,8235,19,-2,-3,14,-3,0,0,4
3454,16/07/2013,8252,8252,8178,8201,127,-126,-126,-125,-51,1,0,4
3455,17/07/2013,8217,8269,8138,8255,139,342,176,657,38,0,1,4
3456,18/07/2013,8239,8337,8216,8337,392,70,106,568,98,0,1,5
3457,19/07/2013,8299,8337,8284,8332,-105,-45,-45,-195,33,0,0,6
3458,22/07/2013,8343,8374,8310,8331,-90,-191,-68,-349,-12,1,0,5
3459,23/07/2013,8359,8366,8307,8314,-391,-350,-52,-793,-45,1,0,5
3460,24/07/2013,8325,8415,8318,8379,-52,52,42,42,54,0,1,6
3461,25/07/2013,8350,8357,8265,8299,-432,-76,48,-460,-51,1,0,6
3462,26/07/2013,8342,8362,8217,8245,4,95,-48,51,-97,0,0,7
3463,29/07/2013,8307,8324,8246,8259,-71,-27,-215,-313,-48,1,0,7
3464,30/07/2013,8302,8334,8256,8271,284,104,-291,97,-31,0,0,8
3465,31/07/2013,8235,8296,8213,8276,272,-39,-277,-44,41,0,0,7
3466,01/08/2013,8320,8411,8317,8411,-249,302,-212,-159,91,0,0,6
3467,02/08/2013,8429,8432,8376,8407,-471,-429,2,-898,-22,1,0,5
3468,05/08/2013,8416,8435,8367,8398,-492,434,-160,-218,-18,1,0,6
3469,06/08/2013,8388,8435,8268,8300,332,319,110,761,-88,0,0,6
3470,07/08/2013,8265,8282,8228,8260,25,-708,117,-566,-5,1,0,5
3471,08/08/2013,8256,8341,8252,8318,142,-176,14,-20,62,0,0,5
3472,09/08/2013,8333,8375,8286,8338,142,-51,137,228,5,0,1,4
3473,12/08/2013,8342,8371,8239,8359,98,102,181,381,17,0,1,5
3474,13/08/2013,8396,8445,8383,8416,333,109,275,717,20,0,1,5
3475,14/08/2013,8425,8457,8401,8438,-362,79,-156,-439,13,0,0,6
3476,15/08/2013,8419,8422,8308,8376,66,-426,-388,-748,-43,1,0,6
3477,16/08/2013,8348,8402,8330,8392,155,106,52,313,44,0,1,7
3478,19/08/2013,8395,8395,8329,8366,153,-98,91,146,-29,0,0,7
3479,20/08/2013,8295,8320,8246,8300,170,339,-164,345,5,0,1,6
3480,21/08/2013,8301,8311,8268,8285,89,95,-29,155,-16,0,0,7
3481,22/08/2013,8289,8425,8284,8398,270,281,188,739,109,0,1,6
3482,23/08/2013,8398,8438,8360,8417,177,331,138,646,19,0,1,7
3483,26/08/2013,8424,8438,8386,8435,-29,-106,32,-103,11,0,0,7
3484,27/08/2013,8379,8424,8243,8243,-127,-1119,-109,-1355,-136,1,0,6
3485,28/08/2013,8203,8219,8094,8158,280,-1157,-208,-1085,-45,1,0,6
3486,29/08/2013,8189,8199,8130,8195,130,-254,25,-99,6,0,0,7
3487,30/08/2013,8198,8201,8102,8103,-490,-408,-195,-1093,-95,1,0,6
3488,02/09/2013,8224,8269,8211,8244,-13,-399,116,-296,20,0,0,6
3489,03/09/2013,8259,8265,8143,8181,155,148,-379,-76,-78,1,0,6
3490,04/09/2013,8202,8207,8096,8196,-30,-279,-132,-441,-6,1,0,6
3491,05/09/2013,8206,8258,8165,8235,109,191,-31,269,29,0,1,7
3492,06/09/2013,8222,8296,8174,8276,-101,210,108,217,54,0,1,7
3493,09/09/2013,8275,8310,8247,8276,169,-579,94,-316,1,0,0,7
3494,10/09/2013,8358,8464,8350,8447,36,312,316,664,89,0,1,7
3495,11/09/2013,8453,8503,8447,8496,274,26,-35,265,43,0,1,7
3496,12/09/2013,8509,8517,8467,8494,435,-46,-46,343,-15,0,0,7
3497,13/09/2013,8461,8518,8457,8509,-87,244,83,240,48,0,1,7
3498,16/09/2013,8600,8626,8578,8613,435,78,-40,473,13,0,1,7
3499,17/09/2013,8596,8614,8585,8597,76,1,1,78,1,0,1,8
3500,18/09/2013,8617,8646,8595,8636,148,19,132,299,19,0,1,8
3501,19/09/2013,8735,8770,8666,8694,260,74,9,343,-41,0,0,8
3502,20/09/2013,8693,8714,8666,8676,-86,-100,52,-134,-17,1,0,7
3503,23/09/2013,8683,8699,8606,8635,-145,-44,-208,-397,-48,1,0,7
3504,24/09/2013,8645,8672,8633,8665,-330,-60,158,-232,20,0,0,8
3505,25/09/2013,8655,8682,8610,8666,51,161,168,380,11,0,1,7
3506,26/09/2013,8679,8688,8629,8664,-234,137,-12,-109,-15,1,0,7
3507,27/09/2013,8673,8691,8611,8662,34,322,-60,296,-11,0,0,8
3508,30/09/2013,8563,8607,8547,8594,18,89,52,159,31,0,1,7
3509,01/10/2013,8619,8692,8612,8689,-101,229,-102,26,70,0,1,7
3510,02/10/2013,8651,8672,8581,8629,68,418,158,644,-22,0,0,7
3511,03/10/2013,8648,8655,8590,8598,11,-331,15,-305,-50,1,0,6
3512,04/10/2013,8591,8640,8570,8623,154,-17,36,173,32,0,1,7
3513,07/10/2013,8557,8605,8510,8592,205,21,201,427,35,0,1,7
3514,08/10/2013,8591,8610,8552,8556,-133,-88,-235,-456,-35,1,0,7
3515,09/10/2013,8541,8590,8490,8517,-376,421,22,67,-24,0,0,8
3516,10/10/2013,8563,8694,8548,8686,132,784,101,1017,123,0,1,7
3517,11/10/2013,8705,8729,8696,8725,1,205,212,418,20,0,1,7
3518,14/10/2013,8688,8728,8676,8724,-367,22,-126,-471,36,0,0,8
3519,15/10/2013,8757,8821,8757,8804,-382,-253,47,-588,47,0,0,7
3520,16/10/2013,8793,8861,8781,8846,392,67,53,512,53,0,1,6
3521,17/10/2013,8817,8830,8765,8812,230,-263,-130,-163,-5,1,0,7
3522,18/10/2013,8850,8865,8805,8865,-165,-234,15,-384,15,0,0,7
3523,21/10/2013,8828,8876,8827,8867,-26,80,25,79,39,0,1,6
3524,22/10/2013,8854,8988,8849,8947,591,116,45,752,93,0,1,6
3525,23/10/2013,8907,8933,8898,8920,712,-16,-1,695,13,0,1,6
3526,24/10/2013,8968,8987,8951,8981,-138,-272,-45,-455,13,0,0,7
3527,25/10/2013,8953,9011,8944,8986,580,68,-57,591,33,0,1,6
3528,28/10/2013,9013,9018,8950,8979,147,122,68,337,-34,0,0,6
3529,29/10/2013,8966,9022,8966,9022,224,-353,140,11,56,0,1,6
3530,30/10/2013,9030,9070,8996,9010,-397,-68,32,-433,-20,1,0,7
3531,31/10/2013,8985,9037,8976,9034,112,-5,239,346,49,0,1,7
3532,01/11/2013,9032,9048,8993,9008,199,86,136,421,-24,0,0,7
3533,04/11/2013,9036,9054,9019,9037,-467,-182,30,-619,1,0,0,7
3534,05/11/2013,9036,9042,8962,9009,-183,44,-110,-249,-27,1,0,6
3535,06/11/2013,9030,9066,9022,9041,129,83,110,322,11,0,1,6
3536,07/11/2013,9038,9194,9026,9081,-7,366,19,378,43,0,1,6
3537,08/11/2013,9037,9079,8986,9078,-313,-635,-253,-1201,41,0,0,7
3538,11/11/2013,9082,9124,9065,9108,267,13,-243,37,26,0,1,6
3539,12/11/2013,9103,9124,9074,9076,-374,-302,-152,-828,-27,1,0,7
3540,13/11/2013,9057,9075,8981,9055,-280,255,70,45,-2,0,0,7
3541,14/11/2013,9137,9151,9101,9150,267,-165,-74,28,13,0,1,6
3542,15/11/2013,9158,9188,9134,9169,-39,405,144,510,11,0,1,6
3543,18/11/2013,9154,9254,9141,9225,-93,546,177,630,71,0,1,7
3544,19/11/2013,9197,9217,9179,9193,633,-248,100,485,-4,0,0,8
3545,20/11/2013,9176,9237,9163,9202,159,-155,-40,-36,26,0,0,7
3546,21/11/2013,9128,9211,9117,9196,-102,79,51,28,68,0,1,6
3547,22/11/2013,9211,9230,9169,9219,120,-224,-5,-109,8,0,0,6
3548,25/11/2013,9258,9323,9253,9300,-99,232,37,170,42,0,1,6
3549,26/11/2013,9298,9317,9287,9290,648,-402,-54,192,-8,0,0,6
3550,27/11/2013,9309,9363,9296,9351,-382,32,72,-278,42,0,0,5
3551,28/11/2013,9360,9400,9359,9387,682,-80,-154,448,27,0,1,5
3552,29/11/2013,9379,9425,9377,9405,435,-80,-91,264,26,0,1,5
3553,02/12/2013,9413,9425,9384,9402,614,102,233,949,-11,0,0,5
3554,03/12/2013,9398,9404,9223,9223,-89,-177,-52,-318,-175,1,0,4
3555,04/12/2013,9247,9253,9070,9141,-69,428,-44,315,-106,0,0,5
3556,05/12/2013,9111,9172,9078,9085,-7,-375,-7,-389,-26,1,0,5
3557,06/12/2013,9126,9196,9084,9172,14,178,46,238,46,0,1,5
3558,09/12/2013,9219,9226,9171,9195,-267,77,-47,-237,-24,1,0,6
3559,10/12/2013,9180,9224,9092,9114,160,26,-381,-195,-66,1,0,6
3560,11/12/2013,9093,9153,9066,9077,44,261,-152,153,-16,0,0,7
3561,12/12/2013,9033,9061,8984,9017,-1,-111,-112,-224,-16,1,0,7
3562,13/12/2013,9017,9047,8991,9006,-10,-18,249,221,-11,0,0,7
3563,16/12/2013,9005,9188,8998,9164,-14,90,3,79,159,0,1,6
3564,17/12/2013,9143,9162,9085,9085,-158,-52,-35,-245,-58,1,0,7
3565,18/12/2013,9145,9191,9122,9182,-18,143,-32,93,37,0,1,7
3566,19/12/2013,9280,9352,9257,9336,19,448,-42,425,56,0,1,8
3567,20/12/2013,9371,9413,9353,9400,-94,181,-10,77,29,0,1,8
3568,23/12/2013,9436,9489,9428,9489,53,88,53,194,53,0,1,8
3569,27/12/2013,9559,9589,9549,9589,-4,30,30,56,30,0,1,8
3570,30/12/2013,9587,9594,9552,9552,9,-35,-323,-349,-35,1,0,8
3571,02/01/2014,9598,9621,9394,9400,-205,-202,-198,-605,-198,1,0,9
3572,03/01/2014,9410,9453,9368,9435,474,-61,-53,360,25,0,1,9
3573,06/01/2014,9419,9469,9400,9428,127,-120,146,153,9,0,1,10
3574,07/01/2014,9446,9519,9417,9506,-133,134,307,308,60,0,1,10
3575,08/01/2014,9513,9516,9468,9498,-93,81,177,165,-15,0,0,10
3576,09/01/2014,9492,9550,9403,9422,66,60,279,405,-70,0,0,9
3577,10/01/2014,9474,9530,9441,9473,-158,-6,48,-116,-1,1,0,8
3578,13/01/2014,9498,9519,9457,9510,-190,21,-47,-216,12,0,0,8
3579,14/01/2014,9391,9541,9382,9541,358,172,410,940,150,0,1,7
3580,15/01/2014,9591,9747,9582,9734,390,161,112,663,143,0,1,7
3581,16/01/2014,9742,9747,9703,9718,24,-103,-103,-182,-24,1,0,7
3582,17/01/2014,9718,9790,9709,9743,192,-127,8,73,25,0,1,7
3583,20/01/2014,9713,9733,9672,9716,277,43,43,363,3,0,1,7
3584,21/01/2014,9752,9794,9714,9730,-32,-108,-230,-370,-22,1,0,7
3585,22/01/2014,9752,9766,9677,9720,-124,-402,-139,-665,-32,1,0,7
3586,23/01/2014,9691,9729,9596,9631,1,546,183,730,-60,0,0,8
3587,24/01/2014,9647,9664,9374,9392,-157,-476,-426,-1059,-255,1,0,8
3588,27/01/2014,9389,9403,9311,9349,-284,-317,-40,-641,-40,1,0,8
3589,28/01/2014,9406,9428,9346,9407,1,640,17,658,1,0,1,9
3590,29/01/2014,9507,9538,9221,9337,-170,320,-500,-350,-170,1,0,9
3591,30/01/2014,9344,9415,9267,9373,-79,134,29,84,29,0,1,9
3592,31/01/2014,9340,9347,9166,9306,-153,234,-34,47,-34,0,0,9
3593,03/02/2014,9319,9358,9174,9187,-155,-366,-237,-758,-132,1,0,8
3594,04/02/2014,9126,9167,9071,9128,2,-318,2,-314,2,0,0,8
3595,05/02/2014,9105,9155,9081,9116,-151,-250,-151,-552,11,0,0,7
3596,06/02/2014,9166,9274,9129,9257,-76,-37,33,-80,91,0,0,6
3597,07/02/2014,9275,9323,9223,9302,-293,82,112,-99,27,0,0,6
3598,10/02/2014,9332,9346,9280,9290,238,747,280,1265,-42,0,0,5
3599,11/02/2014,9339,9479,9338,9479,35,270,-189,116,140,0,1,4
3600,12/02/2014,9505,9595,9502,9540,-25,181,-57,99,35,0,1,4
3601,13/02/2014,9523,9601,9480,9597,74,88,74,236,74,0,1,4
3602,14/02/2014,9616,9678,9593,9662,199,199,199,597,46,0,1,4
3603,17/02/2014,9662,9682,9646,9657,-32,-5,-5,-42,-5,1,0,5
3604,18/02/2014,9675,9691,9614,9660,-15,-52,13,-54,-15,1,0,5
3605,19/02/2014,9641,9696,9596,9660,-15,181,19,185,19,0,1,6
3606,20/02/2014,9525,9619,9504,9619,614,-1,192,805,94,0,1,7
3607,21/02/2014,9665,9666,9598,9657,-292,-127,146,-273,-8,1,0,8
3608,24/02/2014,9620,9709,9603,9709,-87,81,34,28,89,0,1,9
3609,25/02/2014,9677,9711,9629,9699,-26,52,-104,-78,22,0,0,10
3610,26/02/2014,9708,9721,9613,9662,-331,99,-97,-329,-46,1,0,9
3611,27/02/2014,9661,9673,9498,9588,277,65,52,394,-73,0,0,9
3612,28/02/2014,9593,9692,9566,9692,78,-49,22,51,99,0,1,8
3613,03/03/2014,9553,9554,9359,9359,-424,-124,91,-457,-194,1,0,8
3614,04/03/2014,9454,9590,9421,9589,361,361,361,1083,135,0,1,8
3615,05/03/2014,9562,9599,9534,9542,-36,-137,-375,-548,-20,1,0,8
3616,06/03/2014,9577,9587,9505,9543,79,345,22,446,-34,0,0,8
3617,07/03/2014,9538,9543,9347,9351,-49,305,-167,89,-187,0,0,7
3618,10/03/2014,9306,9383,9216,9266,-53,-40,-40,-133,-40,1,0,6
3619,11/03/2014,9295,9375,9259,9308,84,95,84,263,13,0,1,6
3620,12/03/2014,9257,9267,9143,9189,-68,250,-107,75,-68,0,0,7
3621,13/03/2014,9200,9227,9017,9018,-151,-189,-151,-491,-182,1,0,6
3622,14/03/2014,8939,9094,8913,9056,117,36,117,270,117,0,1,7
3623,17/03/2014,9047,9198,9047,9181,171,11,134,316,134,0,1,7
3624,18/03/2014,9172,9315,9106,9243,-120,116,-47,-51,71,0,0,7
3625,19/03/2014,9263,9326,9222,9277,12,-792,61,-719,14,0,0,6
3626,20/03/2014,9216,9297,9157,9296,233,354,58,645,80,0,1,5
3627,21/03/2014,9301,9377,9288,9343,-73,-58,141,10,42,0,1,6
3628,24/03/2014,9350,9359,9181,9189,31,-243,13,-199,-161,1,0,7
3629,25/03/2014,9224,9372,9224,9338,-26,70,61,105,114,0,1,7
3630,26/03/2014,9368,9489,9360,9449,59,145,113,317,81,0,1,7
3631,27/03/2014,9429,9469,9398,9451,19,-17,-305,-303,22,0,0,8
3632,28/03/2014,9487,9587,9485,9587,-26,77,100,151,100,0,1,7
3633,31/03/2014,9622,9635,9543,9556,-67,-60,-66,-193,-66,1,0,7
3634,01/04/2014,9602,9631,9575,9604,-225,19,-157,-363,2,0,0,7
3635,02/04/2014,9629,9646,9608,9623,66,-198,-198,-330,-6,1,0,7
3636,03/04/2014,9621,9690,9592,9629,230,154,174,558,8,0,1,8
3637,04/04/2014,9642,9722,9628,9696,-26,-147,-218,-391,54,0,0,8
3638,07/04/2014,9586,9608,9497,9511,224,-142,-92,-10,-75,1,0,7
3639,08/04/2014,9525,9526,9392,9491,-14,36,79,101,-34,0,0,7
3640,09/04/2014,9507,9542,9481,9506,-38,-18,-1,-57,-1,1,0,6
3641,10/04/2014,9557,9581,9441,9455,-13,59,-39,7,-102,0,0,6
3642,11/04/2014,9351,9390,9259,9315,-3,648,-61,584,-36,0,0,6
3643,14/04/2014,9249,9339,9214,9339,101,130,90,321,90,0,1,5
3644,15/04/2014,9325,9345,9167,9174,72,-203,-151,-282,-151,1,0,5
3645,16/04/2014,9252,9319,9221,9318,66,76,66,208,66,0,1,6
3646,17/04/2014,9311,9418,9277,9410,1,-418,74,-343,99,0,0,6
3647,22/04/2014,9456,9603,9440,9600,413,-150,151,414,144,0,1,5
3648,23/04/2014,9602,9608,9540,9544,-58,-58,-157,-273,-58,1,0,6
3649,24/04/2014,9597,9645,9410,9549,23,-98,-121,-196,-48,1,0,6
3650,25/04/2014,9475,9502,9367,9402,-94,230,-121,15,-73,0,0,7
3651,28/04/2014,9455,9497,9408,9446,-145,328,177,360,-9,0,0,6
3652,29/04/2014,9522,9596,9481,9584,155,-11,189,333,62,0,1,6
3653,30/04/2014,9577,9619,9561,9603,78,7,-4,81,26,0,1,7
3654,02/05/2014,9612,9627,9533,9556,-5,110,-30,75,-56,0,0,7
3655,05/05/2014,9536,9548,9407,9530,119,-44,-6,69,-6,0,0,6
3656,06/05/2014,9570,9571,9440,9467,-23,-368,-87,-478,-103,1,0,5
3657,07/05/2014,9418,9554,9410,9521,394,24,306,724,103,0,1,6
3658,08/05/2014,9547,9622,9487,9607,-218,-34,-165,-417,60,0,0,6
3659,09/05/2014,9591,9602,9558,9581,149,98,108,355,-10,0,0,5
3660,12/05/2014,9608,9587,9710,9702,-235,-51,51,-235,94,0,0,4
3661,13/05/2014,9751,9732,9783,9754,73,300,61,434,3,0,1,4
3662,14/05/2014,9765,9772,9733,9754,393,22,55,470,-11,0,0,5
3663,15/05/2014,9741,9810,9631,9656,-134,45,-71,-160,-85,1,0,4
3664,16/05/2014,9646,9670,9577,9629,168,212,-50,330,-17,0,0,4
3665,19/05/2014,9607,9676,9534,9659,6,37,110,153,52,0,1,4
3666,20/05/2014,9644,9685,9621,9639,209,110,-170,149,-5,0,0,5
3667,21/05/2014,9615,9709,9583,9697,457,-355,-397,-295,82,0,0,4
3668,22/05/2014,9731,9734,9689,9720,-44,-85,175,46,-11,0,0,3
3669,23/05/2014,9723,9780,9705,9768,-59,-124,-10,-193,45,0,0,3
3670,27/05/2014,9893,9951,9879,9940,37,-199,-22,-184,47,0,0,3
3671,28/05/2014,9950,9957,9898,9939,150,83,83,316,-11,0,0,3
3672,29/05/2014,9937,9956,9917,9938,-87,-49,-79,-215,1,0,0,2
3673,30/05/2014,9926,9970,9924,9943,34,-75,83,42,17,0,1,2
3674,02/06/2014,9986,9992,9907,9950,334,-16,20,338,-36,0,0,2
3675,03/06/2014,9949,9954,9887,9919,463,-192,-292,-21,-30,1,0,2
3676,04/06/2014,9903,9928,9866,9926,159,-145,-31,-17,23,0,0,2
3677,05/06/2014,9929,10011,9896,9947,-154,-1115,-216,-1485,18,0,0,2
