,Date,Open,High,Low,Close,a1,a2,a3,a4,pl,,,
2000,14/12/2007,13515,13515,13332,13340,-382,-370,214,-538,-175,1,,
2001,17/12/2007,13339,13340,13158,13167,177,-315,-23,-161,-172,1,0,
2002,18/12/2007,13169,13280,13092,13232,105,63,63,231,63,0,1,
2003,19/12/2007,13232,13300,13147,13207,266,411,43,720,-25,0,0,
2004,20/12/2007,13206,13288,13154,13246,-11,113,43,145,40,0,1,
2005,21/12/2007,13242,13474,13242,13451,491,144,484,1119,209,0,1,
2006,24/12/2007,13451,13564,13449,13550,-6,236,-254,-24,99,0,0,
2007,26/12/2007,13548,13563,13493,13552,79,-352,81,-192,4,0,0,
2008,27/12/2007,13549,13551,13349,13360,-65,-695,-119,-879,-189,1,0,
2009,28/12/2007,13361,13451,13298,13366,397,64,173,634,5,0,1,
2010,31/12/2007,13364,13365,13246,13265,210,42,-60,192,-99,0,0,
2011,02/01/2008,13262,13280,12991,13044,-145,-76,-200,-421,-218,1,0,
2012,03/01/2008,13044,13138,13024,13057,392,935,-425,902,13,0,1,6
2013,04/01/2008,13047,13047,12789,12800,-247,471,-257,-33,-247,1,0,6
2014,07/01/2008,12801,12884,12734,12828,27,188,27,242,27,0,1,7
2015,08/01/2008,12821,12906,12565,12589,-391,22,-232,-601,-232,1,0,7
2016,09/01/2008,12590,12739,12502,12735,145,311,145,601,145,0,1,7
2017,10/01/2008,12733,12931,12632,12853,-87,54,-40,-73,120,0,0,8
2018,11/01/2008,12851,12851,12544,12606,-386,54,122,-210,-245,1,0,8
2019,14/01/2008,12614,12795,12614,12778,337,164,389,890,164,0,1,8
2020,15/01/2008,12778,12778,12489,12501,-684,-766,-355,-1805,-277,1,0,8
2021,16/01/2008,12477,12613,12392,12466,140,578,140,858,-11,0,0,9
2022,17/01/2008,12467,12518,12126,12159,-464,-458,-75,-997,-308,1,0,8
2023,18/01/2008,12160,12342,12022,12099,-22,676,-22,632,-61,0,0,8
2024,22/01/2008,12093,12093,11635,11971,28,249,28,305,-122,0,0,7
2025,23/01/2008,11969,12277,11645,12270,301,358,301,960,301,0,1,6
2026,24/01/2008,12273,12399,12242,12379,97,519,129,745,106,0,1,6
2027,25/01/2008,12392,12487,12184,12207,89,-256,57,-110,-185,1,0,6
2028,28/01/2008,12206,12386,12112,12384,612,142,348,1102,178,0,1,7
2029,29/01/2008,12385,12503,12347,12480,-119,10,95,-14,95,0,0,7
2030,30/01/2008,12480,12681,12406,12443,337,-384,-46,-93,-37,1,0,6
2031,31/01/2008,12438,12702,12250,12650,-192,233,394,435,212,0,1,6
2032,01/02/2008,12638,12768,12602,12743,94,97,105,296,105,0,1,7
2033,04/02/2008,12743,12750,12622,12635,-478,-306,-108,-892,-108,1,0,7
2034,05/02/2008,12632,12632,12264,12265,-367,-430,-341,-1138,-367,1,0,8
2035,06/02/2008,12257,12390,12178,12200,-353,-57,-123,-533,-57,1,0,9
2036,07/02/2008,12196,12332,12120,12247,65,51,275,391,51,0,1,9
2037,08/02/2008,12248,12282,12103,12182,117,33,-123,27,-66,0,0,9
2038,11/02/2008,12182,12252,12070,12240,360,58,275,693,58,0,1,8
2039,12/02/2008,12242,12469,12242,12373,841,127,201,1169,131,0,1,8
2040,13/02/2008,12368,12573,12368,12552,481,9,197,687,184,0,1,9
2041,14/02/2008,12552,12558,12362,12377,-175,-90,-224,-489,-175,1,0,9
2042,15/02/2008,12377,12377,12279,12348,488,-289,-367,-168,-29,1,0,9
2043,19/02/2008,12350,12505,12304,12337,-97,265,44,212,-13,0,0,9
2044,20/02/2008,12333,12464,12228,12427,107,-57,36,86,94,0,1,8
2045,21/02/2008,12427,12504,12247,12284,-22,527,-67,438,-143,0,0,8
2046,22/02/2008,12281,12398,12155,12381,415,100,81,596,100,0,1,7
2047,25/02/2008,12381,12585,12341,12570,169,172,820,1161,189,0,1,7
2048,26/02/2008,12570,12734,12512,12685,-44,-68,29,-83,115,0,0,8
2049,27/02/2008,12684,12757,12609,12694,-323,55,10,-258,10,0,0,7
2050,28/02/2008,12689,12689,12536,12582,-107,-170,-100,-377,-107,1,0,6
2051,29/02/2008,12580,12580,12224,12266,-300,-212,-416,-928,-314,1,0,6
2052,03/03/2008,12264,12281,12161,12259,-288,28,31,-229,-5,1,0,6
2053,04/03/2008,12259,12259,12032,12214,-390,-45,31,-404,-45,1,0,6
2054,05/03/2008,12205,12350,12140,12255,-196,587,50,441,50,0,1,7
2055,06/03/2008,12255,12255,12026,12040,-240,-215,-209,-664,-215,1,0,7
2056,07/03/2008,12039,12094,11820,11894,-180,390,-385,-175,-145,1,0,8
2057,10/03/2008,11893,11926,11732,11740,-153,-541,-153,-847,-153,1,0,8
2058,11/03/2008,11741,12161,11741,12157,416,669,416,1501,416,0,1,8
2059,12/03/2008,12149,12303,12092,12110,405,-49,-58,298,-39,0,0,9
2060,13/03/2008,12096,12215,11876,12146,61,-210,-158,-307,50,0,0,9
2061,14/03/2008,12146,12194,11833,11951,-253,-135,-741,-1129,-195,1,0,8
2062,17/03/2008,11946,12076,11757,11972,314,73,69,456,26,0,1,8
2063,18/03/2008,11976,12393,11976,12393,246,417,-137,526,417,0,1,8
2064,19/03/2008,12392,12462,12095,12100,-292,-297,-292,-881,-292,1,0,8
2065,20/03/2008,12102,12379,12098,12361,505,414,-34,885,259,0,1,8
2066,24/03/2008,12362,12622,12362,12549,187,-71,-131,-15,187,0,0,8
2067,25/03/2008,12547,12572,12449,12533,-14,34,-14,6,-14,0,0,7
2068,26/03/2008,12532,12532,12377,12423,-109,-126,-48,-283,-109,1,0,6
2069,27/03/2008,12422,12477,12293,12302,117,-185,-210,-278,-120,1,0,6
2070,28/03/2008,12304,12382,12197,12216,-508,15,-788,-1281,-88,1,0,7
2071,31/03/2008,12216,12326,12176,12263,-171,285,367,481,47,0,1,8
2072,01/04/2008,12267,12660,12266,12654,868,292,480,1640,387,0,1,8
2073,02/04/2008,12652,12696,12555,12609,167,-2,-107,58,-43,0,0,8
2074,03/04/2008,12606,12675,12528,12626,-286,-301,-281,-868,20,0,0,7
2075,04/04/2008,12626,12688,12528,12609,261,-151,191,301,-17,0,0,6
2076,07/04/2008,12613,12734,12583,12612,156,-39,-169,-52,-1,1,0,5
2077,08/04/2008,12603,12607,12526,12576,-136,132,-219,-223,-27,1,0,6
2078,09/04/2008,12575,12622,12469,12527,248,-262,237,223,-48,0,0,7
2079,10/04/2008,12527,12649,12497,12582,592,-75,339,856,55,0,1,6
2080,11/04/2008,12580,12580,12302,12325,-303,184,-448,-567,-255,1,0,6
2081,14/04/2008,12325,12368,12280,12302,547,53,254,854,-23,0,0,6
2082,15/04/2008,12302,12388,12270,12362,165,269,60,494,60,0,1,5
2083,16/04/2008,12372,12626,12372,12619,123,123,484,730,247,0,1,5
2084,17/04/2008,12617,12657,12563,12620,13,-113,250,150,3,0,1,6
2085,18/04/2008,12627,12894,12627,12849,177,471,250,898,222,0,1,7
2086,21/04/2008,12851,12851,12751,12825,-39,-26,-26,-91,-26,1,0,8
2087,22/04/2008,12825,12825,12657,12720,-143,-255,-298,-696,-105,1,0,8
2088,23/04/2008,12722,12837,12703,12763,70,94,54,218,41,0,1,8
2089,24/04/2008,12765,12942,12707,12849,-73,-168,286,45,84,0,1,9
2090,25/04/2008,12848,12909,12743,12892,381,180,140,701,44,0,1,9
2091,28/04/2008,12891,12939,12858,12872,-96,55,14,-27,-19,1,0,9
2092,29/04/2008,12870,12890,12805,12832,209,-408,-445,-644,-38,1,0,10
2093,30/04/2008,12832,13010,12809,12820,825,500,40,1365,-12,0,0,10
2094,01/05/2008,12818,13029,12793,13010,121,412,188,721,192,0,1,9
2095,02/05/2008,13012,13132,12982,13058,-388,-69,-228,-685,46,0,0,9
2096,05/05/2008,13057,13058,12940,12970,-534,56,-11,-489,-87,1,0,8
2097,06/05/2008,12969,13046,12863,13021,202,-118,13,97,52,0,1,8
2098,07/05/2008,13011,13037,12796,12814,682,-317,158,523,-197,0,0,8
2099,08/05/2008,12814,12910,12795,12867,-86,363,249,526,53,0,1,7
2100,09/05/2008,12861,12861,12715,12746,-302,267,-71,-106,-115,1,0,7
2101,12/05/2008,12746,12904,12740,12876,-272,-8,79,-201,130,0,0,7
2102,13/05/2008,12872,12891,12781,12832,103,-232,78,-51,-40,1,0,6
2103,14/05/2008,12825,12993,12825,12898,612,-416,60,256,73,0,1,6
2104,15/05/2008,12891,13000,12855,12993,45,1012,355,1412,102,0,1,7
2105,16/05/2008,12993,13002,12894,12987,380,-119,134,395,-6,0,0,7
2106,19/05/2008,12985,13137,12964,13028,175,-74,-44,57,43,0,1,7
2107,20/05/2008,13026,13026,12782,12829,78,252,171,501,-197,0,0,7
2108,21/05/2008,12825,12862,12574,12601,-12,-343,-105,-460,-224,1,0,6
2109,22/05/2008,12598,12669,12591,12626,26,-78,-123,-175,28,0,0,7
2110,23/05/2008,12621,12622,12460,12480,-12,-648,-152,-812,-141,1,0,6
2111,27/05/2008,12480,12572,12443,12548,126,-197,68,-3,68,0,0,6
2112,28/05/2008,12543,12602,12495,12594,-343,39,464,160,51,0,1,6
2113,29/05/2008,12594,12727,12555,12646,27,-145,647,529,52,0,1,6
2114,30/05/2008,12647,12690,12617,12638,6,-292,-111,-397,-9,1,0,6
2115,02/06/2008,12638,12638,12428,12504,-89,85,-147,-151,-134,1,0,6
2116,03/06/2008,12503,12554,12342,12403,625,93,-2,716,-100,0,0,7
2117,04/06/2008,12392,12496,12339,12390,159,-293,76,-58,-2,1,0,6
2118,05/06/2008,12389,12611,12389,12604,433,926,-65,1294,215,0,1,7
2119,06/06/2008,12603,12603,12192,12210,-1088,-607,-229,-1924,-393,1,0,7
2120,09/06/2008,12210,12332,12195,12280,488,1412,93,1993,70,0,1,8
2121,10/06/2008,12278,12369,12207,12290,-11,155,8,152,12,0,1,8
2122,11/06/2008,12286,12287,12079,12084,107,-142,-88,-123,-202,1,0,9
2123,12/06/2008,12090,12269,12077,12142,-177,-821,-177,-1175,52,0,0,9
2124,13/06/2008,12145,12310,12145,12307,212,-621,279,-130,162,0,0,8
2125,16/06/2008,12307,12320,12212,12269,-276,-46,-202,-524,-38,1,0,7
2126,17/06/2008,12270,12323,12150,12160,89,123,-110,102,-110,0,0,7
2127,18/06/2008,12159,12159,11994,12029,-481,1,-215,-695,-130,1,0,7
2128,19/06/2008,12029,12115,11978,12063,11,-471,-3,-463,34,0,0,7
2129,20/06/2008,12062,12062,11819,11843,-369,-166,-32,-567,-219,1,0,6
2130,23/06/2008,11844,11987,11731,11842,-123,693,-289,281,-2,0,0,6
2131,24/06/2008,11842,11904,11726,11807,92,-578,93,-393,-35,1,0,5
2132,25/06/2008,11805,11924,11789,11812,144,-680,-284,-820,7,0,0,5
2133,26/06/2008,11809,11809,11453,11453,-300,-627,-585,-1512,-356,1,0,4
2134,27/06/2008,11453,11485,11298,11346,-110,358,-110,138,-107,0,0,5
2135,30/06/2008,11346,11437,11288,11350,-247,701,-247,207,4,0,1,5
2136,01/07/2008,11345,11408,11183,11382,37,-473,37,-399,37,0,0,5
2137,02/07/2008,11382,11434,11214,11216,-491,-166,-289,-946,-166,1,0,5
2138,03/07/2008,11216,11338,11157,11288,69,-50,72,91,72,0,1,5
2139,07/07/2008,11289,11399,11121,11232,208,44,-259,-7,-57,1,0,6
2140,08/07/2008,11225,11391,11175,11384,158,-158,191,191,159,0,1,6
2141,09/07/2008,11382,11418,11142,11147,-841,314,-280,-807,-235,1,0,7
2142,10/07/2008,11148,11270,11087,11229,243,339,197,779,81,0,1,7
2143,11/07/2008,11226,11241,10978,11100,407,-219,469,657,-126,0,0,8
2144,14/07/2008,11104,11239,11004,11055,841,228,222,1291,-49,0,0,7
2145,15/07/2008,11051,11124,10828,10962,-312,-182,11,-483,-89,1,0,7
2146,16/07/2008,10962,11244,10918,11239,515,-625,-6,-116,277,0,0,7
2147,17/07/2008,11238,11447,11210,11447,919,-359,209,769,209,0,1,7
2148,18/07/2008,11437,11511,11382,11497,89,89,462,640,60,0,1,7
2149,21/07/2008,11495,11560,11424,11467,-270,-409,-4,-683,-28,1,0,7
2150,22/07/2008,11458,11617,11387,11602,3,92,145,240,144,0,1,7
2151,23/07/2008,11603,11698,11558,11632,207,444,207,858,29,0,1,7
2152,24/07/2008,11630,11634,11345,11349,-387,-387,-440,-1214,-281,1,0,7
2153,25/07/2008,11341,11444,11325,11371,-655,-101,414,-342,30,0,0,7
2154,28/07/2008,11370,11370,11125,11131,79,-273,-102,-296,-239,1,0,7
2155,29/07/2008,11133,11398,11128,11398,429,265,-329,365,265,0,1,8
2156,30/07/2008,11398,11587,11398,11584,137,189,208,534,186,0,1,8
2157,31/07/2008,11578,11579,11364,11378,-184,85,-236,-335,-200,1,0,9
2158,01/08/2008,11380,11426,11267,11326,132,-131,123,124,-54,0,0,9
2159,04/08/2008,11326,11382,11222,11284,-257,-193,32,-418,-42,1,0,8
2160,05/08/2008,11286,11616,11286,11616,348,246,336,930,330,0,1,8
2161,06/08/2008,11604,11686,11521,11656,52,3,126,181,52,0,1,8
2162,07/08/2008,11655,11656,11417,11431,-872,-191,-264,-1327,-224,1,0,8
2163,08/08/2008,11432,11760,11388,11734,206,443,405,1054,302,0,1,8
2164,11/08/2008,11730,11867,11676,11782,173,89,197,459,52,0,1,9
2165,12/08/2008,11782,11782,11602,11642,-242,-229,-261,-732,-140,1,0,9
2166,13/08/2008,11633,11634,11453,11533,267,527,-223,571,-100,0,0,9
2167,14/08/2008,11532,11718,11451,11616,524,-118,253,659,84,0,1,8
2168,15/08/2008,11611,11710,11600,11660,-378,61,338,21,49,0,1,8
2169,18/08/2008,11660,11690,11434,11479,-281,-375,-179,-835,-181,1,0,9
2170,19/08/2008,11478,11478,11318,11349,241,-78,-116,47,-129,0,0,9
2171,20/08/2008,11346,11454,11291,11417,505,-356,99,248,71,0,1,8
2172,21/08/2008,11415,11476,11316,11430,147,206,541,894,15,0,1,8
2173,22/08/2008,11427,11632,11427,11628,306,-229,-23,54,201,0,1,8
2174,25/08/2008,11626,11626,11363,11386,-6,156,-199,-49,-240,1,0,8
2175,26/08/2008,11384,11436,11340,11413,-382,-279,-80,-741,29,0,0,8
2176,27/08/2008,11412,11554,11382,11502,-227,385,53,211,90,0,1,7
2177,28/08/2008,11500,11715,11500,11715,293,396,-92,597,215,0,1,8
2178,29/08/2008,11713,11713,11543,11544,-169,-200,-169,-538,-169,1,0,8
2179,02/09/2008,11546,11790,11472,11517,108,463,-25,546,-29,0,0,8
2180,03/09/2008,11506,11554,11416,11533,176,531,42,749,27,0,1,7
2181,04/09/2008,11532,11532,11176,11188,-299,-201,-370,-870,-344,1,0,8
2182,05/09/2008,11186,11245,11038,11221,-839,1177,-210,128,35,0,1,8
2183,08/09/2008,11225,11571,11225,11511,-75,301,85,311,286,0,1,8
2184,09/09/2008,11515,11578,11231,11231,-162,-141,-380,-683,-284,1,0,8
2185,10/09/2008,11234,11381,11215,11269,-227,132,85,-10,35,0,0,8
2186,11/09/2008,11264,11446,11099,11434,474,311,10,795,170,0,1,8
2187,12/09/2008,11429,11460,11280,11422,29,-302,124,-149,-7,1,0,8
2188,15/09/2008,11416,11416,10918,10918,-476,-730,-361,-1567,-498,1,0,8
2189,16/09/2008,10906,11093,10743,11059,153,-229,153,77,153,0,1,8
2190,17/09/2008,11057,11057,10596,10610,-462,-670,-333,-1465,-447,1,0,9
2191,18/09/2008,10609,11076,10459,11020,411,647,411,1469,411,0,1,9
2192,19/09/2008,11028,11483,11027,11388,369,539,671,1579,360,0,1,9
2193,22/09/2008,11394,11395,10992,11016,-192,-283,-252,-727,-378,1,0,9
2194,23/09/2008,11016,11143,10834,10854,63,-108,-190,-235,-162,1,0,9
2195,24/09/2008,10850,10928,10754,10825,-252,-148,119,-281,-25,1,0,9
2196,25/09/2008,10827,11129,10827,11022,5,608,205,818,195,0,1,10
2197,26/09/2008,11019,11168,10869,11143,399,168,414,981,124,0,1,10
2198,29/09/2008,11140,11140,10366,10366,-192,-1126,-628,-1946,-774,1,0,10
2199,30/09/2008,10372,10869,10371,10851,479,216,479,1174,479,0,1,10
2200,01/10/2008,10847,10882,10632,10831,80,-298,-196,-414,-16,1,0,10
2201,02/10/2008,10826,10826,10440,10483,-202,-170,-343,-715,-343,1,0,10
2202,03/10/2008,10484,10796,10310,10325,-391,-159,-159,-709,-159,1,0,10
2203,06/10/2008,10322,10323,9525,9956,-300,-492,-300,-1092,-366,1,0,10
2204,07/10/2008,9955,10124,9437,9447,-508,-508,-508,-1524,-508,1,0,10
2205,08/10/2008,9437,9628,9195,9258,-179,-179,-179,-537,-179,1,0,10
2206,09/10/2008,9262,9448,8579,8579,-683,-683,-683,-2049,-683,1,0,10
2207,10/10/2008,8569,8901,7882,8451,-118,-118,-118,-354,-118,1,0,10
2208,13/10/2008,8462,9428,8462,9388,926,926,926,2778,926,0,1,10
2209,14/10/2008,9389,9794,9085,9311,42,-443,-78,-479,-78,1,0,10
2210,15/10/2008,9302,9309,8530,8578,-626,-921,-425,-1972,-724,1,0,10
2211,16/10/2008,8577,9013,8198,8979,402,402,402,1206,402,0,1,10
2212,17/10/2008,8975,9281,8718,8852,-418,-148,-257,-823,-123,1,0,10
2213,20/10/2008,8852,9267,8852,9265,437,608,464,1509,413,0,1,10
2214,21/10/2008,9263,9285,9004,9034,-323,-159,-212,-694,-229,1,0,10
2215,22/10/2008,9028,9028,8335,8519,-470,-322,-389,-1181,-509,1,0,10
2216,23/10/2008,8520,8796,8244,8691,66,171,171,408,171,0,1,10
2217,24/10/2008,8683,8683,8188,8379,-300,-190,-135,-625,-304,1,0,10
2218,27/10/2008,8376,8599,8144,8176,-247,669,-247,175,-200,0,0,10
2219,28/10/2008,8179,9082,8175,9065,886,886,886,2658,886,0,1,9
2220,29/10/2008,9062,9363,8890,8991,-30,-71,-71,-172,-71,1,0,9
2221,30/10/2008,9005,9266,8977,9181,163,-303,176,36,176,0,1,9
2222,31/10/2008,9179,9454,9119,9325,-112,146,146,180,146,0,1,9
2223,03/11/2008,9326,9411,9256,9320,-6,-6,-6,-18,-6,1,0,9
2224,04/11/2008,9324,9654,9324,9625,301,301,301,903,301,0,1,9
2225,05/11/2008,9617,9617,9112,9139,-478,-478,-478,-1434,-478,1,0,9
2226,06/11/2008,9134,9155,8637,8696,-173,-1167,-238,-1578,-438,1,0,9
2227,07/11/2008,8696,8962,8696,8944,248,248,2,498,248,0,1,9
2228,10/11/2008,8947,9160,8760,8870,-86,-77,-1,-164,-77,1,0,9
2229,11/11/2008,8864,8868,8561,8694,-291,42,-329,-578,-170,1,0,10
2230,12/11/2008,8684,8685,8265,8283,-520,-401,-622,-1543,-401,1,0,10
2231,13/11/2008,8281,8877,7965,8835,554,554,554,1662,554,0,1,10
2232,14/11/2008,8822,8923,8470,8497,86,-315,-267,-496,-325,1,0,10
2233,17/11/2008,8495,8571,8247,8274,-283,-221,-622,-1126,-221,1,0,10
2234,18/11/2008,8273,8478,8105,8425,152,152,152,456,152,0,1,10
2235,19/11/2008,8421,8505,7987,7997,-560,-356,-329,-1245,-424,1,0,10
2236,20/11/2008,7996,8187,7507,7552,-444,899,-444,11,-444,0,0,10
2237,21/11/2008,7552,8072,7449,8046,494,494,494,1482,494,0,1,9
2238,24/11/2008,8048,8599,8048,8443,464,405,395,1264,395,0,1,9
2239,25/11/2008,8445,8607,8282,8480,-34,-14,270,222,35,0,1,9
2240,26/11/2008,8464,8727,8311,8727,3,261,266,530,263,0,1,9
2241,28/11/2008,8725,8831,8673,8829,84,152,101,337,104,0,1,9
2242,01/12/2008,8827,8827,8141,8149,-678,-678,-678,-2034,-678,1,0,9
2243,02/12/2008,8154,8437,8144,8419,418,333,168,919,265,0,1,9
2244,03/12/2008,8409,8624,8234,8592,842,354,108,1304,183,0,1,9
2245,04/12/2008,8587,8632,8259,8376,-212,-339,-130,-681,-211,1,0,9
2246,05/12/2008,8376,8686,8118,8635,-386,709,526,849,259,0,1,9
2247,08/12/2008,8638,9026,8638,8934,179,191,491,861,296,0,1,10
2248,09/12/2008,8934,8934,8652,8691,-702,-243,-243,-1188,-243,1,0,10
2249,10/12/2008,8693,8879,8646,8761,125,46,418,589,68,0,1,10
2250,11/12/2008,8750,8810,8513,8565,70,-148,-248,-326,-185,1,0,10
2251,12/12/2008,8563,8683,8348,8630,16,327,-147,196,67,0,1,10
2252,15/12/2008,8629,8676,8469,8564,-325,-23,-448,-796,-65,1,0,10
2253,16/12/2008,8566,8959,8566,8924,880,147,525,1552,358,0,1,10
2254,17/12/2008,8922,8961,8778,8824,-98,-98,-40,-236,-98,1,0,10
2255,18/12/2008,8824,8883,8527,8605,-198,-113,-176,-487,-219,1,0,10
2256,19/12/2008,8606,8787,8550,8579,-17,127,-294,-184,-27,1,0,10
2257,22/12/2008,8573,8601,8372,8520,75,-416,-248,-589,-53,1,0,10
2258,23/12/2008,8519,8604,8391,8420,-26,398,541,913,-99,0,0,10
2259,24/12/2008,8417,8498,8417,8468,220,587,161,968,51,0,1,9
2260,26/12/2008,8469,8533,8462,8516,-134,318,47,231,47,0,1,9
2261,29/12/2008,8516,8531,8364,8484,157,114,-69,202,-32,0,0,9
2262,30/12/2008,8488,8675,8488,8668,-243,176,263,196,180,0,1,8
2263,31/12/2008,8666,8843,8665,8776,-294,207,-16,-103,110,0,0,8
2264,02/01/2009,8772,9065,8761,9035,-93,454,307,668,263,0,1,7
2265,05/01/2009,9027,9034,8892,8953,-230,-74,-74,-378,-74,1,0,7
2266,06/01/2009,8955,9088,8941,9015,232,-42,-23,167,60,0,1,7
2267,07/01/2009,8997,8997,8720,8770,-493,-118,-203,-814,-227,1,0,7
2268,08/01/2009,8770,8770,8651,8742,-460,-103,-146,-709,-28,1,0,7
2269,09/01/2009,8739,8770,8577,8599,-182,-179,132,-229,-140,1,0,8
2270,12/01/2009,8599,8603,8421,8474,-272,-96,-56,-424,-125,1,0,8
2271,13/01/2009,8475,8522,8377,8449,104,-26,-26,52,-26,0,0,8
2272,14/01/2009,8446,8446,8141,8200,-246,-246,2,-490,-246,1,0,8
2273,15/01/2009,8196,8286,7995,8212,-85,409,-85,239,16,0,1,8
2274,16/01/2009,8216,8341,8109,8281,68,65,220,353,65,0,1,9
2275,20/01/2009,8280,8292,7940,7949,-349,-1106,-278,-1733,-331,1,0,9
2276,21/01/2009,7949,8244,7936,8228,279,669,279,1227,279,0,1,9
2277,22/01/2009,8224,8225,7957,8123,-238,290,19,71,-101,0,0,9
2278,23/01/2009,8109,8153,7909,8078,-45,-95,-31,-171,-31,1,0,8
2279,26/01/2009,8078,8232,8023,8116,203,121,228,552,38,0,1,8
2280,27/01/2009,8117,8226,8083,8175,-185,-171,-52,-408,58,0,0,8
2281,28/01/2009,8176,8406,8176,8376,-230,200,495,465,200,0,1,7
2282,29/01/2009,8373,8373,8138,8149,-196,-204,-76,-476,-224,1,0,8
2283,30/01/2009,8149,8196,7962,8001,-4,-148,-16,-168,-148,1,0,8
2284,02/02/2009,8001,8001,7867,7937,385,-64,36,357,-64,0,0,8
2285,03/02/2009,7937,8112,7906,8078,-142,-133,166,-109,141,0,0,7
2286,04/02/2009,8070,8162,7929,7957,295,-284,-371,-360,-113,1,0,6
2287,05/02/2009,7955,8108,7845,8063,874,324,312,1510,108,0,1,6
2288,06/02/2009,8056,8312,8052,8281,615,126,8,749,225,0,1,7
2289,09/02/2009,8281,8315,8196,8271,-71,-160,-15,-246,-10,1,0,7
2290,10/02/2009,8269,8269,7849,7889,-387,-63,-362,-812,-380,1,0,7
2291,11/02/2009,7887,7984,7852,7940,183,-375,-3,-195,53,0,0,8
2292,12/02/2009,7932,7939,7694,7933,-619,-229,-88,-936,1,0,0,7
2293,13/02/2009,7933,7971,7840,7850,-154,-170,-145,-469,-83,1,0,6
2294,17/02/2009,7846,7846,7551,7553,-325,-27,-224,-576,-293,1,0,6
2295,18/02/2009,7546,7618,7480,7556,10,317,10,337,10,0,1,7
2296,19/02/2009,7555,7615,7448,7466,-89,-443,-89,-621,-89,1,0,8
2297,20/02/2009,7462,7469,7250,7366,-96,119,176,199,-96,0,0,8
2298,23/02/2009,7366,7441,7106,7115,-292,-598,-292,-1182,-251,1,0,7
2299,24/02/2009,7115,7379,7114,7351,236,647,236,1119,236,0,1,7
2300,25/02/2009,7350,7405,7157,7271,93,191,334,618,-79,0,0,7
2301,26/02/2009,7269,7402,7174,7182,-87,-87,-150,-324,-87,1,0,6
2302,27/02/2009,7181,7196,7034,7063,351,-225,-205,-79,-118,1,0,7
2303,02/03/2009,7056,7059,6755,6763,-293,105,-293,-481,-293,1,0,8
2304,03/03/2009,6765,6855,6706,6726,-39,358,-39,280,-39,0,0,8
2305,04/03/2009,6726,6979,6726,6876,28,96,28,152,150,0,1,7
2306,05/03/2009,6874,6874,6544,6594,-427,602,-521,-346,-280,1,0,7
2307,06/03/2009,6595,6755,6470,6627,32,261,32,325,32,0,1,7
2308,09/03/2009,6626,6710,6517,6547,-50,179,-79,50,-79,0,0,8
2309,10/03/2009,6547,6926,6547,6926,627,320,627,1574,379,0,1,7
2310,11/03/2009,6923,7015,6868,6930,142,-302,29,-131,7,0,0,7
2311,12/03/2009,6932,7185,6872,7170,656,399,273,1328,238,0,1,7
2312,13/03/2009,7167,7243,7106,7224,85,57,57,199,57,0,1,7
2313,16/03/2009,7225,7393,7207,7217,-235,24,-8,-219,-8,1,0,7
2314,17/03/2009,7218,7397,7172,7396,207,444,207,858,178,0,1,7
2315,18/03/2009,7396,7572,7257,7487,91,91,91,273,91,0,1,8
2316,19/03/2009,7490,7548,7369,7401,-89,-89,-89,-267,-89,1,0,8
2317,20/03/2009,7402,7461,7258,7278,232,178,150,560,-124,0,0,8
2318,23/03/2009,7279,7781,7279,7776,409,589,227,1225,497,0,1,7
2319,24/03/2009,7774,7797,7647,7660,-248,-114,-114,-476,-114,1,0,8
2320,25/03/2009,7660,7864,7550,7750,232,-83,227,376,90,0,1,8
2321,26/03/2009,7752,7931,7752,7925,173,287,227,687,173,0,1,9
2322,27/03/2009,7923,7923,7736,7776,-46,-147,-147,-340,-147,1,0,9
2323,30/03/2009,7773,7773,7438,7522,-286,-100,-77,-463,-251,1,0,9
2324,31/03/2009,7524,7725,7524,7609,83,218,145,446,85,0,1,9
2325,01/04/2009,7606,7789,7484,7762,-253,305,469,521,156,0,1,9
2326,02/04/2009,7764,8076,7764,7978,236,150,303,689,214,0,1,9
2327,03/04/2009,7981,8020,7897,8018,148,89,197,434,37,0,1,9
2328,06/04/2009,8016,8016,7862,7976,-681,-66,-66,-813,-40,1,0,10
2329,07/04/2009,7969,7969,7762,7790,-883,-695,-466,-2044,-179,1,0,10
2330,08/04/2009,7789,7888,7751,7837,613,278,266,1157,48,0,1,10
2331,09/04/2009,7840,8087,7840,8083,-2,574,271,843,243,0,1,10
2332,13/04/2009,8082,8113,7964,8058,-858,-16,-135,-1009,-24,1,0,10
2333,14/04/2009,8057,8057,7902,7920,-395,-198,-45,-638,-137,1,0,10
2334,15/04/2009,7915,8041,7870,8030,81,532,189,802,115,0,1,10
2335,16/04/2009,8029,8168,7963,8125,129,99,-26,202,96,0,1,10
2336,17/04/2009,8125,8191,8087,8131,-485,-28,24,-489,6,0,0,10
2337,20/04/2009,8129,8129,7840,7842,-250,58,-493,-685,-287,1,0,9
2338,21/04/2009,7842,7979,7792,7970,128,-345,128,-89,128,0,0,9
2339,22/04/2009,7965,8045,7868,7887,550,240,469,1259,-78,0,0,8
2340,23/04/2009,7887,7979,7804,7957,-86,43,82,39,70,0,1,7
2341,24/04/2009,7958,8128,7958,8076,-57,-25,296,214,118,0,1,7
2342,27/04/2009,8074,8123,7987,8025,223,-110,13,126,-49,0,0,7
2343,28/04/2009,8024,8092,7939,8017,592,41,-446,187,-7,0,0,6
2344,29/04/2009,8018,8258,8018,8186,162,273,250,685,168,0,1,5
2345,30/04/2009,8188,8308,8137,8168,-165,187,73,95,-20,0,0,5
2346,01/05/2009,8167,8220,8099,8212,-121,-648,-234,-1003,45,0,0,4
2347,04/05/2009,8214,8435,8214,8427,-575,-37,261,-351,213,0,0,4
2348,05/05/2009,8426,8458,8363,8411,-36,-15,-15,-66,-15,1,0,3
2349,06/05/2009,8404,8519,8403,8512,7,19,197,223,108,0,1,4
2350,07/05/2009,8512,8577,8358,8410,-220,-79,-139,-438,-102,1,0,5
2351,08/05/2009,8411,8588,8411,8575,-250,133,-140,-257,164,0,0,5
2352,11/05/2009,8569,8569,8410,8419,138,-44,-44,50,-150,0,0,4
2353,12/05/2009,8419,8518,8366,8469,240,-30,-26,184,50,0,1,4
2354,13/05/2009,8462,8462,8262,8285,-112,309,13,210,-177,0,0,5
2355,14/05/2009,8286,8377,8274,8331,-86,363,82,359,45,0,1,4
2356,15/05/2009,8326,8395,8230,8269,-613,177,-37,-473,-57,1,0,5
2357,18/05/2009,8270,8512,8270,8504,289,217,232,738,234,0,1,6
2358,19/05/2009,8502,8538,8464,8475,77,-297,-5,-225,-27,1,0,7
2359,20/05/2009,8472,8592,8406,8422,-296,-18,157,-157,-50,1,0,7
2360,21/05/2009,8416,8416,8221,8292,-617,-479,303,-793,-124,1,0,7
2361,22/05/2009,8292,8364,8257,8277,-259,-1016,-326,-1601,-15,1,0,7
2362,26/05/2009,8277,8496,8227,8474,160,-67,14,107,197,0,1,8
2363,27/05/2009,8474,8497,8289,8300,-229,-43,-71,-343,-174,1,0,9
2364,28/05/2009,8300,8435,8247,8404,89,-147,-106,-164,104,0,0,9
2365,29/05/2009,8404,8523,8368,8500,-84,41,-11,-54,96,0,0,9
2366,01/06/2009,8502,8761,8501,8721,93,516,349,958,219,0,1,8
2367,02/06/2009,8722,8787,8694,8741,246,-161,-161,-76,19,0,0,8
2368,03/06/2009,8740,8740,8598,8675,173,189,126,488,-65,0,0,7
2369,04/06/2009,8675,8751,8635,8750,-609,-181,-122,-912,75,0,0,6
2370,05/06/2009,8752,8839,8700,8763,26,-114,-132,-220,11,0,0,5
2371,08/06/2009,8759,8824,8633,8764,-570,-187,-39,-796,5,0,0,4
2372,09/06/2009,8765,8803,8725,8763,-217,174,154,111,-2,0,0,3
2373,10/06/2009,8764,8835,8640,8739,-152,-355,-134,-641,-25,1,0,2
2374,11/06/2009,8736,8878,8736,8771,912,-457,69,524,35,0,1,2
2375,12/06/2009,8770,8806,8717,8799,-187,164,219,196,29,0,1,3
2376,15/06/2009,8798,8798,8578,8612,-131,-18,-423,-572,-186,1,0,4
2377,16/06/2009,8612,8644,8499,8505,-51,-436,-107,-594,-107,1,0,4
2378,17/06/2009,8504,8563,8461,8497,-49,504,93,548,-7,0,0,5
2379,18/06/2009,8497,8590,8475,8556,189,59,90,338,59,0,1,5
2380,19/06/2009,8557,8617,8497,8540,-128,-374,-553,-1055,-17,1,0,6
2381,22/06/2009,8538,8539,8335,8339,-335,10,-447,-772,-199,1,0,7
2382,23/06/2009,8340,8371,8286,8323,-4,-74,-17,-95,-17,1,0,8
2383,24/06/2009,8324,8428,8260,8300,139,54,-24,169,-24,0,0,9
2384,25/06/2009,8299,8490,8259,8472,395,112,50,557,173,0,1,8
2385,26/06/2009,8468,8469,8401,8438,295,1,110,406,-30,0,0,8
2386,29/06/2009,8440,8533,8429,8529,216,-228,161,149,89,0,1,7
2387,30/06/2009,8529,8560,8394,8447,-235,-445,-36,-716,-82,1,0,7
2388,01/07/2009,8448,8580,8448,8504,336,239,79,654,56,0,1,7
2389,02/07/2009,8503,8503,8281,8281,-252,-237,-177,-666,-222,1,0,8
2390,06/07/2009,8281,8328,8206,8325,-502,266,-51,-287,44,0,0,8
2391,07/07/2009,8325,8326,8154,8164,-39,191,-303,-151,-161,1,0,7
2392,08/07/2009,8164,8220,8087,8178,64,339,279,682,14,0,1,7
2393,09/07/2009,8179,8229,8145,8183,-353,328,-112,-137,4,0,0,7
2394,10/07/2009,8182,8184,8093,8146,168,-216,-284,-332,-36,1,0,7
2395,13/07/2009,8146,8332,8130,8332,356,-2,175,529,186,0,1,7
2396,14/07/2009,8331,8361,8285,8360,-643,-65,29,-679,29,0,0,8
2397,15/07/2009,8364,8628,8364,8616,142,402,556,1100,252,0,1,7
2398,16/07/2009,8613,8740,8584,8712,176,99,99,374,99,0,1,7
2399,17/07/2009,8712,8754,8674,8744,72,24,32,128,32,0,1,7
2400,20/07/2009,8746,8855,8746,8848,102,178,102,382,102,0,1,7
2401,21/07/2009,8848,8927,8811,8916,-271,120,68,-83,68,0,0,8
2402,22/07/2009,8912,8950,8860,8881,-46,-19,-71,-136,-31,1,0,7
2403,23/07/2009,8882,9097,8866,9069,232,104,106,442,187,0,1,7
2404,24/07/2009,9066,9101,9007,9093,-114,58,27,-29,27,0,0,8
2405,27/07/2009,9093,9123,9034,9108,-145,-457,-279,-881,15,0,0,7
2406,28/07/2009,9107,9125,9008,9097,116,-75,-75,-34,-10,1,0,6
2407,29/07/2009,9092,9095,9014,9071,-582,-118,-228,-928,-21,1,0,7
2408,30/07/2009,9073,9246,9073,9154,457,-333,288,412,81,0,1,7
2409,31/07/2009,9155,9219,9134,9172,-76,94,153,171,17,0,1,7
2410,03/08/2009,9174,9298,9174,9287,-510,-56,-169,-735,113,0,0,7
2411,04/08/2009,9285,9321,9251,9320,-581,-77,76,-582,35,0,0,6
2412,05/08/2009,9315,9318,9206,9281,-642,-305,161,-786,-34,1,0,6
2413,06/08/2009,9277,9325,9209,9256,330,-314,-355,-339,-21,1,0,6
2414,07/08/2009,9258,9438,9258,9370,536,126,232,894,112,0,1,6
2415,10/08/2009,9368,9372,9290,9338,96,-18,-148,-70,-30,1,0,7
2416,11/08/2009,9334,9334,9217,9242,174,457,-335,296,-92,0,0,8
2417,12/08/2009,9236,9424,9221,9362,610,794,540,1944,126,0,1,7
2418,13/08/2009,9362,9406,9305,9398,255,-136,182,301,36,0,1,7
2419,14/08/2009,9398,9402,9233,9321,-688,-577,-495,-1760,-77,1,0,7
2420,17/08/2009,9314,9314,9116,9135,-221,52,-198,-367,-179,1,0,7
2421,18/08/2009,9134,9234,9134,9218,203,-55,84,232,84,0,1,8
2422,19/08/2009,9209,9313,9132,9279,39,146,-492,-307,70,0,0,9
2423,20/08/2009,9279,9364,9268,9350,141,1167,-161,1147,71,0,1,8
2424,21/08/2009,9348,9519,9347,9506,270,-185,255,340,158,0,1,8
2425,24/08/2009,9506,9588,9486,9509,-858,-309,-36,-1203,3,0,0,8
2426,25/08/2009,9509,9620,9509,9539,-558,97,76,-385,30,0,0,7
2427,26/08/2009,9539,9583,9486,9544,-558,-47,-455,-1060,5,0,0,7
2428,27/08/2009,9542,9610,9459,9581,-165,187,73,95,39,0,1,6
2429,28/08/2009,9583,9630,9496,9544,-657,-22,154,-525,-39,1,0,6
2430,31/08/2009,9543,9543,9436,9496,-8,401,-17,376,-47,0,0,6
2431,01/09/2009,9492,9558,9292,9311,-174,-345,-167,-686,-181,1,0,5
2432,02/09/2009,9306,9331,9262,9281,51,-96,417,372,-25,0,0,5
2433,03/09/2009,9282,9350,9253,9345,69,33,103,205,63,0,1,5
2434,04/09/2009,9345,9446,9322,9441,-227,96,-175,-306,96,0,0,5
2435,08/09/2009,9440,9511,9440,9497,171,-10,-25,136,57,0,1,4
2436,09/09/2009,9497,9577,9476,9547,-166,-97,-167,-430,50,0,0,5
2437,10/09/2009,9546,9633,9508,9628,78,52,-44,86,82,0,1,5
2438,11/09/2009,9625,9650,9572,9605,170,-316,-130,-276,-20,1,0,6
2439,14/09/2009,9598,9631,9536,9627,209,-113,-15,81,29,0,1,6
2440,15/09/2009,9626,9714,9581,9683,70,172,63,305,57,0,1,6
2441,16/09/2009,9684,9800,9679,9792,-852,-752,-240,-1844,108,0,0,7
2442,17/09/2009,9790,9855,9750,9784,-872,-16,-135,-1023,-6,1,0,6
2443,18/09/2009,9785,9848,9785,9820,-582,-400,-125,-1107,35,0,0,7
2444,21/09/2009,9819,9819,9726,9779,-575,-241,47,-769,-40,1,0,6
2445,22/09/2009,9780,9843,9772,9830,174,146,8,328,50,0,1,7
2446,23/09/2009,9831,9918,9741,9749,-14,-308,326,4,-82,0,0,7
2447,24/09/2009,9750,9805,9666,9707,185,-149,346,382,-43,0,0,7
2448,25/09/2009,9707,9736,9641,9665,-141,32,204,95,-42,0,0,6
2449,28/09/2009,9663,9824,9663,9789,82,298,162,542,126,0,1,5
2450,29/09/2009,9790,9834,9739,9742,-558,-75,-446,-1079,-48,1,0,5
2451,30/09/2009,9742,9777,9609,9712,-149,409,-137,123,-30,0,0,5
2452,01/10/2009,9712,9712,9500,9509,348,-264,214,298,-203,0,0,5
2453,02/10/2009,9508,9525,9430,9488,20,-318,264,-34,-20,1,0,4
2454,05/10/2009,9489,9625,9481,9600,547,-158,187,576,111,0,1,5
2455,06/10/2009,9601,9774,9601,9731,200,-96,147,251,130,0,1,5
2456,07/10/2009,9726,9740,9676,9726,58,87,-415,-270,0,0,0,5
2457,08/10/2009,9728,9837,9728,9787,-25,-366,-177,-568,59,0,0,5
2458,09/10/2009,9786,9865,9765,9865,320,686,421,1427,79,0,1,5
2459,12/10/2009,9865,9932,9849,9886,-494,-102,21,-575,21,0,0,6
2460,13/10/2009,9884,9895,9815,9871,-604,134,-11,-481,-13,1,0,5
2461,14/10/2009,9874,10028,9874,10016,-456,-1125,-238,-1819,142,0,0,5
2462,15/10/2009,10015,10063,9978,10063,4,-339,24,-311,48,0,0,5
2463,16/10/2009,10061,10062,9940,9996,-270,90,46,-134,-65,1,0,5
2464,19/10/2009,9997,10118,9995,10092,-121,-234,62,-293,95,0,0,5
2465,20/10/2009,10092,10098,9993,10042,-877,-33,-228,-1138,-50,1,0,4
2466,21/10/2009,10039,10120,9944,9949,125,46,418,589,-90,0,0,4
2467,22/10/2009,9946,10105,9917,10081,550,117,112,779,135,0,1,4
2468,23/10/2009,10100,10110,9932,9972,-50,-55,109,4,-128,0,0,5
2469,26/10/2009,9972,10072,9850,9868,-110,9,-299,-400,-104,1,0,4
2470,27/10/2009,9868,9948,9838,9882,108,212,-358,-38,14,0,0,5
2471,28/10/2009,9881,9902,9758,9763,-421,59,-232,-594,-118,1,0,4
2472,29/10/2009,9763,9970,9759,9963,-50,546,177,673,200,0,1,5
2473,30/10/2009,9962,9962,9684,9713,-388,-28,44,-372,-249,1,0,6
2474,02/11/2009,9712,9859,9679,9789,204,-318,54,-60,77,0,0,6
2475,03/11/2009,9788,9788,9704,9772,-28,-899,-298,-1225,-16,1,0,6
2476,04/11/2009,9767,9928,9767,9802,1,-247,10,-236,35,0,0,6
2477,05/11/2009,9808,10013,9808,10006,-12,421,447,856,198,0,1,6
2478,06/11/2009,10001,10044,9937,10023,31,193,184,408,22,0,1,6
2479,09/11/2009,10021,10228,10021,10227,215,445,491,1151,206,0,1,7
2480,10/11/2009,10223,10261,10198,10247,-255,-268,-203,-726,24,0,0,7
2481,11/11/2009,10247,10342,10246,10291,-80,44,-80,-116,44,0,0,7
2482,12/11/2009,10290,10322,10171,10198,220,104,-95,229,-92,0,0,6
2483,13/11/2009,10198,10306,10192,10270,-582,-167,75,-674,72,0,0,5
2484,16/11/2009,10268,10434,10268,10407,-73,-73,-272,-418,139,0,0,4
2485,17/11/2009,10405,10438,10362,10437,330,246,183,759,32,0,1,4
2486,18/11/2009,10426,10433,10360,10426,-887,1,-38,-924,0,0,0,4
2487,19/11/2009,10425,10425,10256,10332,-96,-101,-24,-221,-93,1,0,4
2488,20/11/2009,10328,10343,10272,10318,309,201,35,545,-10,0,0,4
2489,23/11/2009,10320,10496,10320,10451,-170,108,270,208,131,0,1,3
2490,24/11/2009,10451,10454,10360,10434,-83,-425,35,-473,-17,1,0,3
2491,25/11/2009,10433,10482,10421,10464,-63,307,-236,8,31,0,1,4
2492,27/11/2009,10452,10452,10231,10310,-237,-80,106,-211,-142,1,0,5
2493,30/11/2009,10310,10364,10263,10345,239,257,-44,452,35,0,1,6
2494,01/12/2009,10344,10501,10343,10472,87,536,298,921,128,0,1,7
2495,02/12/2009,10470,10514,10422,10453,510,156,-114,552,-17,0,0,8
2496,03/12/2009,10456,10508,10350,10366,561,-141,-311,109,-90,0,0,7
2497,04/12/2009,10369,10517,10312,10389,8,28,-49,-13,20,0,0,7
2498,07/12/2009,10387,10443,10360,10390,-151,1012,-25,836,3,0,1,6
2499,08/12/2009,10385,10386,10250,10286,33,823,-68,788,-99,0,0,7
2500,09/12/2009,10283,10342,10236,10337,-352,288,202,138,54,0,1,6
2501,10/12/2009,10336,10445,10336,10406,701,556,103,1360,70,0,1,6
2502,11/12/2009,10403,10484,10400,10472,-290,239,-95,-146,69,0,0,6
2503,14/12/2009,10471,10515,10471,10501,124,-232,-234,-342,30,0,0,5
2504,15/12/2009,10499,10499,10427,10452,-804,-537,-502,-1843,-47,1,0,4
2505,16/12/2009,10450,10510,10428,10441,469,205,117,791,-9,0,0,4
2506,17/12/2009,10440,10440,10308,10308,-80,-730,-79,-889,-132,1,0,4
2507,18/12/2009,10309,10372,10264,10329,41,129,20,190,20,0,1,5
2508,21/12/2009,10330,10458,10330,10414,-536,84,84,-368,84,0,0,6
2509,22/12/2009,10415,10480,10415,10465,247,497,50,794,50,0,1,5
2510,23/12/2009,10464,10492,10438,10466,34,458,64,556,2,0,1,6
2511,24/12/2009,10467,10522,10462,10520,-285,436,-88,63,53,0,1,6
2512,28/12/2009,10518,10552,10506,10547,-108,243,204,339,29,0,1,6
2513,29/12/2009,10548,10580,10544,10545,-180,134,251,205,-3,0,0,7
2514,30/12/2009,10544,10551,10506,10548,324,-55,31,300,4,0,1,7
2515,31/12/2009,10548,10555,10423,10428,-237,-90,260,-67,-120,1,0,7
2516,04/01/2010,10431,10605,10431,10584,310,68,-6,372,153,0,1,8
2517,05/01/2010,10585,10585,10522,10572,-675,-17,104,-588,-13,1,0,8
2518,06/01/2010,10565,10595,10547,10574,486,-162,171,495,9,0,1,8
2519,07/01/2010,10571,10612,10505,10607,1023,224,133,1380,36,0,1,9
2520,08/01/2010,10606,10619,10554,10618,341,153,-73,421,12,0,1,9
2521,11/01/2010,10620,10676,10592,10664,536,-375,328,489,44,0,1,9
2522,12/01/2010,10663,10663,10569,10627,-688,-56,57,-687,-36,1,0,9
2523,13/01/2010,10628,10709,10614,10681,620,288,302,1210,53,0,1,9
2524,14/01/2010,10680,10724,10667,10711,-301,-147,115,-333,31,0,0,10
2525,15/01/2010,10707,10710,10561,10610,-166,-342,283,-225,-97,1,0,9
2526,19/01/2010,10608,10730,10592,10725,508,135,835,1478,117,0,1,9
2527,20/01/2010,10720,10720,10517,10603,-209,-297,-401,-907,-117,1,0,9
2528,21/01/2010,10604,10615,10375,10390,-225,-15,-230,-470,-214,1,0,9
2529,22/01/2010,10390,10390,10158,10173,-217,-617,-217,-1051,-217,1,0,9
2530,25/01/2010,10175,10257,10172,10197,22,-314,205,-87,22,0,0,9
2531,26/01/2010,10195,10285,10156,10194,-1,334,-68,265,-1,0,0,8
2532,27/01/2010,10194,10255,10104,10236,105,-921,42,-774,42,0,0,7
2533,28/01/2010,10237,10259,10055,10120,138,112,77,327,-117,0,0,6
2534,29/01/2010,10122,10239,10044,10067,-21,4,-55,-72,-55,1,0,5
2535,01/02/2010,10069,10191,10069,10186,113,-78,53,88,117,0,1,6
2536,02/02/2010,10186,10315,10174,10297,261,28,171,460,111,0,1,6
2537,03/02/2010,10292,10307,10232,10271,124,-125,-34,-35,-21,1,0,6
2538,04/02/2010,10273,10273,9998,10002,-25,-366,-177,-568,-271,1,0,6
2539,05/02/2010,10004,10032,9835,10012,-292,-79,-292,-663,8,0,0,6
2540,08/02/2010,10005,10029,9904,9908,40,759,168,967,-97,0,0,5
2541,09/02/2010,9910,10139,9910,10059,32,43,146,221,149,0,1,5
2542,10/02/2010,10056,10086,9963,10038,502,208,-108,602,-18,0,0,6
2543,11/02/2010,10038,10162,9977,10144,217,485,-108,594,106,0,1,6
2544,12/02/2010,10137,10137,9984,10099,141,81,-38,184,-38,0,0,7
2545,16/02/2010,10101,10280,10101,10269,231,397,-19,609,168,0,1,6
2546,17/02/2010,10262,10320,10262,10309,343,365,394,1102,47,0,1,6
2547,18/02/2010,10309,10407,10294,10393,296,-123,198,371,84,0,1,6
2548,19/02/2010,10388,10439,10339,10402,-212,95,14,-103,14,0,0,6
2549,22/02/2010,10402,10434,10369,10383,-532,48,48,-436,-19,1,0,5
2550,23/02/2010,10383,10411,10268,10282,-723,-124,154,-693,-101,1,0,6
2551,24/02/2010,10284,10394,10284,10374,89,-301,-18,-230,90,0,0,7
2552,25/02/2010,10367,10367,10186,10321,-130,7,250,127,-46,0,0,6
2553,26/02/2010,10321,10354,10272,10325,-509,338,152,-19,4,0,0,6
2554,01/03/2010,10326,10414,10326,10404,-167,-189,292,-64,78,0,0,5
2555,02/03/2010,10404,10457,10389,10406,196,-234,376,338,2,0,1,5
2556,03/03/2010,10406,10470,10377,10397,-157,-18,110,-65,-9,1,0,5
2557,04/03/2010,10396,10452,10391,10444,-419,358,326,265,48,0,1,5
2558,05/03/2010,10445,10572,10445,10566,542,-41,364,865,121,0,1,5
2559,08/03/2010,10564,10588,10542,10552,-455,97,76,-282,-12,1,0,6
2560,09/03/2010,10552,10613,10534,10564,-56,-2,-90,-148,12,0,0,6
2561,10/03/2010,10560,10602,10526,10567,182,-1152,250,-720,7,0,0,5
2562,11/03/2010,10561,10612,10507,10612,-62,-116,38,-140,51,0,0,5
2563,12/03/2010,10612,10645,10595,10625,-722,-1024,-161,-1907,13,0,0,5
2564,15/03/2010,10623,10644,10570,10642,24,-22,-81,-79,19,0,0,5
2565,16/03/2010,10642,10694,10622,10686,-166,504,9,347,44,0,1,5
2566,17/03/2010,10686,10768,10686,10734,-14,-293,248,-59,48,0,0,5
2567,18/03/2010,10733,10784,10728,10779,-115,-202,-83,-400,46,0,0,4
2568,19/03/2010,10780,10820,10694,10742,219,94,252,565,-38,0,0,3
2569,22/03/2010,10741,10810,10695,10786,416,-234,115,297,45,0,1,2
2570,23/03/2010,10787,10894,10785,10889,-62,-116,38,-140,102,0,0,2
2571,24/03/2010,10888,10888,10825,10836,-657,-736,-224,-1617,-52,1,0,2
2572,25/03/2010,10838,10956,10834,10841,174,-331,283,126,3,0,1,3
2573,26/03/2010,10841,10909,10816,10850,55,-119,36,-28,9,0,0,4
2574,29/03/2010,10849,10917,10849,10896,87,329,232,648,47,0,1,4
2575,30/03/2010,10895,10940,10867,10907,-448,-234,-21,-703,12,0,0,5
2576,31/03/2010,10907,10907,10833,10857,-137,-191,-225,-553,-50,1,0,4
2577,01/04/2010,10857,10956,10857,10927,185,563,0,748,70,0,1,5
2578,05/04/2010,10928,10988,10924,10974,834,340,125,1299,46,0,1,6
2579,06/04/2010,10972,10987,10928,10970,-365,167,-118,-316,-2,1,0,7
2580,07/04/2010,10962,10963,10846,10898,214,388,-278,324,-64,0,0,7
2581,08/04/2010,10897,10949,10844,10927,-109,182,157,230,30,0,1,7
2582,09/04/2010,10927,11001,10927,10997,129,657,290,1076,70,0,1,7
2583,12/04/2010,10997,11030,10992,11006,264,63,-24,303,9,0,1,7
2584,13/04/2010,11007,11039,10948,11019,542,382,82,1006,12,0,1,8
2585,14/04/2010,11021,11125,11021,11123,461,321,89,871,102,0,1,8
2586,15/04/2010,11123,11155,11096,11145,-41,-173,-192,-406,22,0,0,9
2587,16/04/2010,11144,11154,10974,11019,219,-287,-334,-402,-125,1,0,8
2588,19/04/2010,11018,11095,10978,11092,154,-279,224,99,74,0,1,8
2589,20/04/2010,11093,11146,11082,11117,536,329,154,1019,24,0,1,8
2590,21/04/2010,11117,11154,11071,11125,293,-255,197,235,8,0,1,8
2591,22/04/2010,11120,11150,11016,11134,-89,496,-210,197,14,0,1,9
2592,23/04/2010,11132,11206,11106,11204,188,41,69,298,72,0,1,9
2593,26/04/2010,11205,11258,11188,11205,-125,700,104,679,0,0,0,9
2594,27/04/2010,11204,11219,10973,10992,-254,-262,-366,-882,-212,1,0,8
2595,28/04/2010,10989,11078,10965,11045,-51,-545,-90,-686,56,0,0,8
2596,29/04/2010,11046,11197,11042,11167,614,313,247,1174,121,0,1,7
2597,30/04/2010,11168,11198,11000,11009,-307,94,236,23,-159,0,0,8
2598,03/05/2010,11010,11178,11010,11152,118,363,82,563,142,0,1,7
2599,04/05/2010,11150,11150,10869,10927,-298,-576,-534,-1408,-223,1,0,7
2600,05/05/2010,10918,10947,10815,10867,51,136,17,204,-51,0,0,7
2601,06/05/2010,10868,10880,9870,10520,-4,-190,-302,-496,-348,1,0,6
2602,07/05/2010,10519,10579,10241,10380,-139,377,-139,99,-139,0,0,6
2603,10/05/2010,10386,10835,10386,10785,399,379,399,1177,399,0,1,5
2604,11/05/2010,10780,10874,10685,10748,247,-37,-145,65,-32,0,0,6
2605,12/05/2010,10742,10909,10742,10897,165,-201,48,12,155,0,1,5
2606,13/05/2010,10897,10920,10772,10783,-863,270,-316,-909,-114,1,0,6
2607,14/05/2010,10781,10781,10537,10620,-325,-124,-208,-657,-161,1,0,6
2608,17/05/2010,10617,10661,10436,10626,361,93,-19,435,9,0,1,7
2609,18/05/2010,10626,10719,10482,10511,133,-115,-115,-97,-115,1,0,7
2610,19/05/2010,10506,10522,10325,10444,470,-62,-74,334,-62,0,0,7
2611,20/05/2010,10440,10440,10065,10068,-353,-338,-288,-979,-372,1,0,7
2612,21/05/2010,10064,10198,9919,10193,129,701,129,959,129,0,1,7
2613,24/05/2010,10194,10196,10053,10067,-533,-443,-261,-1237,-127,1,0,8
2614,25/05/2010,10061,10062,9774,10044,-17,317,-17,283,-17,0,0,8
2615,26/05/2010,10045,10179,9953,9974,66,375,-235,206,-71,0,0,8
2616,27/05/2010,9972,10264,9972,10259,243,205,243,691,287,0,1,7
2617,28/05/2010,10258,10258,10096,10137,599,1,-60,540,-121,0,0,7
2618,01/06/2010,10134,10218,10014,10024,64,-104,-117,-157,-110,1,0,6
2619,02/06/2010,10026,10254,10026,10250,476,180,734,1390,224,0,1,6
2620,03/06/2010,10251,10315,10175,10255,537,309,274,1120,4,0,1,6
2621,04/06/2010,10250,10250,9890,9932,-408,162,-489,-735,-318,1,0,7
2622,07/06/2010,9932,9982,9810,9816,18,5,-407,-384,-116,1,0,7
2623,08/06/2010,9813,9954,9758,9940,92,-669,14,-563,127,0,0,7
2624,09/06/2010,9942,10065,9868,9899,-298,-124,-38,-460,-43,1,0,6
2625,10/06/2010,9902,10186,9902,10172,327,375,580,1282,270,0,1,7
2626,11/06/2010,10167,10216,10083,10211,537,-42,273,768,44,0,1,8
2627,14/06/2010,10212,10329,10186,10191,9,102,-21,90,-21,0,0,8
2628,15/06/2010,10192,10408,10192,10405,95,-39,925,981,213,0,1,8
2629,16/06/2010,10404,10429,10333,10410,291,-98,8,201,6,0,1,8
2630,17/06/2010,10410,10441,10319,10434,78,24,24,126,24,0,1,8
2631,18/06/2010,10435,10483,10424,10451,378,13,16,407,16,0,1,8
2632,21/06/2010,10452,10594,10396,10442,-420,92,46,-282,-10,1,0,8
2633,22/06/2010,10442,10494,10283,10294,-835,-22,-119,-976,-148,1,0,8
2634,23/06/2010,10293,10368,10227,10298,-235,-34,42,-227,5,0,0,9
2635,24/06/2010,10297,10298,10129,10153,-85,-166,9,-242,-144,1,0,8
2636,25/06/2010,10154,10203,10081,10144,185,-259,-281,-355,-10,1,0,8
2637,28/06/2010,10143,10202,10101,10138,322,28,-281,69,-5,0,0,8
2638,29/06/2010,10136,10136,9812,9870,-338,-254,-281,-873,-266,1,0,8
2639,30/06/2010,9868,9909,9754,9774,-94,-94,-94,-282,-94,1,0,8
2640,01/07/2010,9773,9796,9622,9732,-41,378,24,361,-41,0,0,8
2641,02/07/2010,9732,9771,9614,9686,-46,-163,-46,-255,-46,1,0,7
2642,06/07/2010,9686,9858,9659,9744,-601,-495,-601,-1697,58,0,0,7
2643,07/07/2010,9744,10027,9737,10018,294,739,274,1307,274,0,1,6
2644,08/07/2010,10019,10140,10019,10139,-974,87,-389,-1276,120,0,0,6
2645,09/07/2010,10139,10202,10118,10198,-480,261,-198,-417,59,0,0,6
2646,12/07/2010,10199,10220,10146,10216,-364,33,-212,-543,17,0,0,5
2647,13/07/2010,10218,10408,10218,10363,145,-64,145,226,145,0,1,4
2648,14/07/2010,10371,10400,10303,10367,-7,-4,-28,-39,-4,1,0,5
2649,15/07/2010,10367,10380,10240,10359,-8,97,-8,81,-8,0,0,5
2650,16/07/2010,10356,10356,10080,10098,-306,-267,-125,-698,-258,1,0,4
2651,19/07/2010,10098,10187,10074,10154,308,-108,25,225,56,0,1,5
2652,20/07/2010,10152,10236,10008,10230,31,189,316,536,78,0,1,5
2653,21/07/2010,10226,10266,10066,10120,-386,-112,108,-390,-106,1,0,6
2654,22/07/2010,10122,10363,10122,10322,-352,283,65,-4,200,0,0,6
2655,23/07/2010,10321,10442,10288,10425,77,1055,-121,1011,104,0,1,6
2656,26/07/2010,10424,10527,10414,10525,148,30,13,191,101,0,1,7
2657,27/07/2010,10525,10578,10495,10538,398,79,350,827,13,0,1,8
2658,28/07/2010,10537,10548,10463,10498,491,115,81,687,-39,0,0,8
2659,29/07/2010,10499,10585,10387,10467,-241,-265,-205,-711,-32,1,0,7
2660,30/07/2010,10465,10507,10348,10466,182,-276,-161,-255,1,0,0,8
2661,02/08/2010,10469,10692,10469,10674,-84,-21,-203,-308,205,0,0,7
2662,03/08/2010,10674,10677,10601,10636,-858,-16,-135,-1009,-38,1,0,6
2663,04/08/2010,10630,10703,10628,10680,-214,-335,-301,-850,50,0,0,6
2664,05/08/2010,10680,10680,10613,10675,-95,55,-128,-168,-5,1,0,5
2665,06/08/2010,10669,10669,10515,10654,316,308,303,927,-15,0,0,6
2666,09/08/2010,10655,10720,10649,10699,557,59,13,629,44,0,1,5
2667,10/08/2010,10697,10701,10552,10644,-575,84,-72,-563,-53,1,0,5
2668,11/08/2010,10632,10632,10367,10379,-331,83,-269,-517,-253,1,0,5
2669,12/08/2010,10362,10362,10269,10320,-49,412,-357,6,-42,0,0,6
2670,13/08/2010,10320,10355,10285,10303,-17,161,-18,126,-17,0,0,5
2671,16/08/2010,10303,10333,10210,10302,-200,-58,-18,-276,-1,1,0,5
2672,17/08/2010,10298,10480,10298,10406,10,66,161,237,108,0,1,6
2673,18/08/2010,10399,10472,10330,10416,-10,472,82,544,17,0,1,6
2674,19/08/2010,10411,10411,10216,10271,726,-100,-155,471,-140,0,0,7
2675,20/08/2010,10271,10271,10147,10214,-203,-126,-207,-536,-57,1,0,6
2676,23/08/2010,10216,10305,10170,10174,-61,190,-304,-175,-42,1,0,7
2677,24/08/2010,10173,10173,9991,10040,-367,-27,293,-101,-133,1,0,7
2678,25/08/2010,10040,10097,9938,10060,294,-642,20,-328,20,0,0,7
2679,26/08/2010,10060,10105,9968,9986,0,82,116,198,-74,0,0,6
2680,27/08/2010,9982,10160,9937,10151,7,-435,205,-223,169,0,0,6
2681,30/08/2010,10146,10151,10008,10010,-228,-110,-369,-707,-136,1,0,6
2682,31/08/2010,10006,10073,9942,10015,107,-145,-21,-59,9,0,0,6
2683,01/09/2010,10016,10279,10016,10270,241,-108,18,151,254,0,1,5
2684,02/09/2010,10270,10320,10254,10320,94,273,-412,-45,50,0,0,5
2685,03/09/2010,10322,10451,10322,10448,56,64,-252,-132,126,0,0,5
2686,07/09/2010,10447,10447,10332,10341,-387,-379,-35,-801,-106,1,0,4
2687,08/09/2010,10338,10427,10336,10387,215,130,209,554,49,0,1,4
2688,09/09/2010,10388,10477,10387,10415,337,-311,237,263,27,0,1,4
2689,10/09/2010,10415,10471,10403,10463,204,-128,-11,65,48,0,1,5
2690,13/09/2010,10459,10568,10459,10544,-604,-68,255,-417,85,0,0,6
2691,14/09/2010,10545,10588,10500,10526,438,96,104,638,-19,0,0,6
2692,15/09/2010,10526,10588,10481,10573,-456,32,-323,-747,47,0,0,5
2693,16/09/2010,10572,10604,10522,10595,-326,-172,93,-405,23,0,0,5
2694,17/09/2010,10596,10650,10567,10608,-250,52,-2,-200,12,0,0,4
2695,20/09/2010,10608,10774,10608,10754,106,471,-2,575,146,0,1,4
2696,21/09/2010,10753,10833,10718,10761,95,-86,-46,-37,8,0,0,5
2697,22/09/2010,10761,10805,10708,10739,-852,-305,161,-996,-22,1,0,4
2698,23/09/2010,10738,10762,10641,10662,-68,-153,102,-119,-76,1,0,4
2699,24/09/2010,10664,10866,10664,10860,-227,262,-66,-31,196,0,0,4
2700,27/09/2010,10860,10873,10810,10812,-852,-131,-166,-1149,-48,1,0,3
2701,28/09/2010,10809,10886,10729,10858,87,199,-223,63,49,0,1,4
2702,29/09/2010,10858,10869,10799,10835,-301,-401,105,-597,-23,1,0,5
2703,30/09/2010,10836,10949,10745,10788,-100,-262,133,-229,-48,1,0,6
2704,01/10/2010,10790,10866,10781,10830,-477,814,-61,276,40,0,1,7
2705,04/10/2010,10829,10854,10711,10751,11,-248,96,-141,-78,1,0,8
2706,05/10/2010,10753,10966,10753,10945,697,-407,114,404,192,0,1,8
2707,06/10/2010,10937,10974,10919,10968,-191,-522,-196,-909,31,0,0,9
2708,07/10/2010,10968,10998,10893,10949,-191,-522,-196,-909,-19,1,0,8
2709,08/10/2010,10948,11032,10929,11006,443,-214,10,239,58,0,1,8
2710,11/10/2010,11007,11030,10978,11010,-447,-998,-197,-1642,3,0,0,9
2711,12/10/2010,11011,11053,10914,11020,-106,-105,-248,-459,9,0,0,8
2712,13/10/2010,11023,11155,11022,11096,-3,856,188,1041,73,0,1,7
2713,14/10/2010,11097,11112,11024,11095,148,264,84,496,-2,0,0,7
2714,15/10/2010,11096,11141,11011,11063,-177,-1024,-799,-2000,-33,1,0,6
2715,18/10/2010,11063,11159,11055,11144,557,311,175,1043,81,0,1,6
2716,19/10/2010,11140,11140,10918,10979,-180,150,-355,-385,-161,1,0,6
2717,20/10/2010,10974,11153,10971,11108,-172,351,278,457,134,0,1,6
2718,21/10/2010,11105,11214,11066,11147,365,521,222,1108,42,0,1,7
2719,22/10/2010,11146,11159,11109,11133,124,-232,-234,-342,-13,1,0,7
2720,25/10/2010,11133,11248,11132,11164,561,141,-61,641,31,0,1,7
2721,26/10/2010,11163,11185,11087,11170,345,36,-192,189,7,0,1,8
2722,27/10/2010,11168,11168,11021,11126,421,173,401,995,-42,0,0,9
2723,28/10/2010,11127,11179,11053,11114,206,443,405,1054,-13,0,0,8
2724,29/10/2010,11120,11131,11076,11118,260,366,-96,530,-2,0,0,8
2725,01/11/2010,11120,11244,11062,11125,-473,-221,-96,-790,5,0,0,7
2726,02/11/2010,11125,11220,11125,11189,154,-409,504,249,64,0,1,6
2727,03/11/2010,11185,11227,11097,11215,-131,-171,-34,-336,30,0,0,6
2728,04/11/2010,11217,11440,11217,11435,478,524,275,1277,218,0,1,5
2729,05/11/2010,11435,11452,11394,11444,-910,-90,-90,-1090,9,0,0,5
2730,08/11/2010,11440,11440,11362,11407,197,-114,-205,-122,-33,1,0,4
2731,09/11/2010,11404,11421,11303,11347,-96,-513,-220,-829,-57,1,0,4
2732,10/11/2010,11343,11366,11255,11357,-77,-56,-37,-170,14,0,0,4
2733,11/11/2010,11327,11327,11231,11283,88,0,-163,-75,-44,1,0,4
2734,12/11/2010,11281,11284,11144,11193,-135,-277,469,57,-88,0,0,5
2735,15/11/2010,11194,11281,11189,11202,-551,-166,326,-391,8,0,0,5
2736,16/11/2010,11195,11195,10979,11024,-337,375,173,211,-171,0,0,5
2737,17/11/2010,11018,11042,10991,11008,-157,-75,-195,-427,-10,1,0,4
2738,18/11/2010,11010,11200,11010,11181,53,-547,53,-441,171,0,0,5
2739,19/11/2010,11181,11206,11119,11204,883,521,84,1488,23,0,1,4
2740,22/11/2010,11202,11206,11054,11179,216,-193,186,209,-23,0,0,5
2741,23/11/2010,11178,11180,10992,11036,-88,-77,161,-4,-142,1,0,4
2742,24/11/2010,11037,11196,11037,11187,130,73,86,289,150,0,1,4
2743,26/11/2010,11184,11184,11067,11092,175,-35,-804,-664,-92,1,0,5
2744,29/11/2010,11084,11084,10929,11052,-202,22,-85,-265,-32,1,0,5
2745,30/11/2010,11050,11063,10943,11006,112,121,84,317,-44,0,0,6
2746,01/12/2010,11007,11276,11007,11256,286,371,139,796,249,0,1,6
2747,02/12/2010,11256,11374,11256,11362,326,106,90,522,106,0,1,7
2748,03/12/2010,11362,11389,11319,11382,25,-358,145,-188,20,0,0,7
2749,06/12/2010,11381,11392,11350,11362,-19,373,145,499,-19,0,0,7
2750,07/12/2010,11364,11451,11354,11359,76,-80,-15,-19,-5,1,0,6
2751,08/12/2010,11354,11389,11328,11372,-403,-375,-78,-856,18,0,0,7
2752,09/12/2010,11370,11413,11332,11370,163,-123,0,40,0,0,0,6
2753,10/12/2010,11370,11414,11358,11410,296,469,40,805,40,0,1,5
2754,13/12/2010,11406,11480,11405,11429,-65,333,171,439,23,0,1,5
2755,14/12/2010,11429,11514,11429,11476,-365,14,83,-268,47,0,0,5
2756,15/12/2010,11476,11519,11446,11458,-365,356,-136,-145,-18,1,0,5
2757,16/12/2010,11458,11515,11421,11499,725,-99,-67,559,41,0,1,5
2758,17/12/2010,11499,11503,11451,11492,-254,343,358,447,-7,0,0,5
2759,20/12/2010,11491,11517,11443,11478,261,422,-76,607,-13,0,0,5
2760,21/12/2010,11478,11549,11478,11533,89,143,35,267,55,0,1,5
2761,22/12/2010,11532,11567,11528,11560,-137,-71,211,3,28,0,1,5
2762,23/12/2010,11559,11581,11543,11574,-237,309,-141,-69,15,0,0,6
2763,27/12/2010,11573,11573,11518,11555,-108,157,197,246,-18,0,0,6
2764,28/12/2010,11555,11591,11541,11576,620,201,-63,758,21,0,1,5
2765,29/12/2010,11573,11625,11573,11585,96,392,85,573,12,0,1,5
2766,30/12/2010,11585,11594,11552,11570,-139,-62,-206,-407,-15,1,0,6
2767,31/12/2010,11569,11597,11530,11578,-419,225,-136,-330,9,0,0,6
2768,03/01/2011,11577,11712,11577,11671,-42,-75,326,209,94,0,1,5
2769,04/01/2011,11671,11698,11636,11691,-180,-342,283,-239,20,0,0,6
2770,05/01/2011,11689,11743,11653,11723,-408,-459,-463,-1330,34,0,0,6
2771,06/01/2011,11717,11737,11668,11697,-68,471,200,603,-20,0,0,5
2772,07/01/2011,11697,11727,11600,11675,214,-62,113,265,-22,0,0,4
2773,10/01/2011,11672,11677,11574,11638,180,225,128,533,-34,0,0,4
2774,11/01/2011,11638,11704,11636,11672,-473,733,-223,37,34,0,1,4
2775,12/01/2011,11674,11782,11674,11755,-509,657,-55,93,81,0,1,4
2776,13/01/2011,11754,11757,11700,11732,-158,-74,-8,-240,-22,1,0,4
2777,14/01/2011,11732,11794,11699,11787,616,-185,-427,4,55,0,1,4
2778,18/01/2011,11784,11859,11778,11838,-108,148,152,192,54,0,1,5
2779,19/01/2011,11834,11861,11798,11825,-65,180,-250,-135,-9,1,0,5
2780,20/01/2011,11824,11845,11745,11823,202,-537,-86,-421,-1,1,0,6
2781,21/01/2011,11823,11906,11823,11872,393,-313,191,271,49,0,1,7
2782,24/01/2011,11873,11983,11868,11980,-3,-466,-160,-629,107,0,0,8
2783,25/01/2011,11980,11986,11899,11977,-957,50,-125,-1032,-3,1,0,8
2784,26/01/2011,11979,12020,11962,11985,-100,12,158,70,6,0,1,9
2785,27/01/2011,11985,12020,11972,11990,-722,-452,136,-1038,5,0,0,9
2786,28/01/2011,11990,12012,11803,11824,-91,-22,-176,-289,-166,1,0,8
2787,31/01/2011,11824,11892,11818,11892,-61,-243,-74,-378,68,0,0,8
2788,01/02/2011,11892,12051,11892,12040,550,772,579,1901,148,0,1,7
2789,02/02/2011,12038,12058,12018,12042,186,294,-179,301,4,0,1,7
2790,03/02/2011,12041,12080,11981,12062,-575,84,-72,-563,21,0,0,7
2791,04/02/2011,12062,12092,12026,12092,-632,-97,56,-673,30,0,0,6
2792,07/02/2011,12092,12189,12092,12162,-166,-342,283,-225,70,0,0,5
2793,08/02/2011,12153,12239,12150,12233,-217,97,-21,-141,80,0,0,5
2794,09/02/2011,12229,12254,12188,12240,-611,-35,-35,-681,11,0,0,4
2795,10/02/2011,12240,12240,12157,12229,-614,-758,-199,-1571,-11,1,0,3
2796,11/02/2011,12228,12286,12180,12273,126,177,-157,146,45,0,1,4
2797,14/02/2011,12267,12276,12236,12268,430,18,-143,305,1,0,1,4
2798,15/02/2011,12267,12268,12193,12227,174,504,-335,343,-40,0,0,5
2799,16/02/2011,12220,12303,12220,12288,89,1,-238,-148,68,0,0,4
2800,17/02/2011,12288,12331,12253,12318,-137,-191,-225,-553,30,0,0,3
2801,18/02/2011,12319,12391,12303,12391,-102,-119,-324,-545,72,0,0,3
2802,22/02/2011,12390,12390,12176,12213,-722,140,-365,-947,-177,1,0,3
2803,23/02/2011,12212,12221,12063,12106,-172,127,-31,-76,-106,1,0,4
2804,24/02/2011,12105,12130,11983,12068,-26,206,-76,104,-37,0,0,5
2805,25/02/2011,12061,12151,12061,12130,110,-116,94,88,69,0,1,5
2806,28/02/2011,12130,12235,12130,12226,176,635,203,1014,96,0,1,5
2807,01/03/2011,12226,12261,12055,12058,-133,182,-356,-307,-168,1,0,5
2808,02/03/2011,12057,12115,12019,12067,26,330,393,749,10,0,1,5
2809,03/03/2011,12068,12283,12068,12258,-287,-927,349,-865,190,0,0,6
2810,04/03/2011,12259,12271,12080,12170,19,340,155,514,-89,0,0,6
2811,07/03/2011,12171,12243,12042,12090,230,50,121,401,-81,0,0,6
2812,08/03/2011,12086,12251,12072,12214,83,152,183,418,128,0,1,6
2813,09/03/2011,12211,12258,12157,12213,-318,-121,2,-437,2,0,0,6
2814,10/03/2011,12211,12211,11974,11985,-974,-312,-250,-1536,-226,1,0,5
2815,11/03/2011,11977,12087,11936,12044,252,672,678,1602,67,0,1,6
2816,14/03/2011,12042,12042,11897,11993,399,-653,169,-85,-49,1,0,6
2817,15/03/2011,11989,11989,11696,11855,-369,-67,18,-418,-134,1,0,6
2818,16/03/2011,11854,11857,11556,11613,-343,-617,-521,-1481,-241,1,0,6
2819,17/03/2011,11615,11800,11615,11775,248,468,248,964,160,0,1,6
2820,18/03/2011,11777,11927,11777,11858,-148,-670,101,-717,81,0,0,7
2821,21/03/2011,11860,12078,11860,12036,-46,-103,372,223,176,0,1,7
2822,22/03/2011,12036,12051,12003,12019,543,-381,-17,145,-17,0,0,8
2823,23/03/2011,12018,12116,11973,12086,-108,-192,357,57,68,0,1,7
2824,24/03/2011,12088,12191,12088,12171,173,429,623,1225,83,0,1,8
2825,25/03/2011,12171,12260,12171,12221,213,81,50,344,50,0,1,8
2826,28/03/2011,12221,12273,12198,12198,-323,99,-23,-247,-23,1,0,8
2827,29/03/2011,12194,12285,12174,12279,85,154,85,324,85,0,1,8
2828,30/03/2011,12280,12384,12280,12351,-669,-77,-123,-869,71,0,0,8
2829,31/03/2011,12351,12382,12319,12320,-669,-196,-196,-1061,-31,1,0,7
2830,01/04/2011,12321,12420,12321,12377,-250,-251,128,-373,56,0,0,7
2831,04/04/2011,12375,12407,12369,12400,-444,298,-24,-170,25,0,0,7
2832,05/04/2011,12402,12438,12353,12394,96,-147,-21,-72,-8,1,0,6
2833,06/04/2011,12387,12451,12387,12427,518,447,428,1393,40,0,1,7
2834,07/04/2011,12426,12441,12328,12410,-83,372,92,381,-16,0,0,7
2835,08/04/2011,12410,12450,12321,12380,199,-278,123,44,-30,0,0,6
2836,11/04/2011,12380,12444,12353,12381,367,-75,245,537,1,0,1,5
2837,12/04/2011,12381,12381,12233,12264,286,316,-356,246,-117,0,0,5
2838,13/04/2011,12264,12335,12224,12271,-208,176,-179,-211,7,0,0,4
2839,14/04/2011,12270,12306,12164,12285,-67,-40,-19,-126,15,0,0,4
2840,15/04/2011,12286,12369,12273,12342,272,-218,-37,17,56,0,1,3
2841,18/04/2011,12340,12340,12094,12202,41,1167,451,1659,-138,0,0,4
2842,19/04/2011,12201,12275,12200,12267,306,340,-179,467,66,0,1,4
2843,20/04/2011,12267,12476,12264,12454,463,-203,700,960,187,0,1,4
2844,21/04/2011,12454,12506,12448,12506,-722,-1024,-161,-1907,52,0,0,4
2845,25/04/2011,12506,12506,12446,12480,-444,-362,-129,-935,-26,1,0,4
2846,26/04/2011,12481,12613,12478,12595,209,106,146,461,114,0,1,5
2847,27/04/2011,12592,12708,12588,12691,309,64,64,437,99,0,1,5
2848,28/04/2011,12690,12776,12674,12763,320,73,73,466,73,0,1,6
2849,29/04/2011,12764,12833,12751,12810,197,395,106,698,46,0,1,7
2850,02/05/2011,12810,12876,12785,12807,523,108,-95,536,-3,0,0,8
2851,03/05/2011,12806,12841,12750,12808,-104,-12,63,-53,2,0,0,7
2852,04/05/2011,12806,12807,12673,12724,2,-153,75,-76,-82,1,0,7
2853,05/05/2011,12724,12725,12521,12584,-460,-99,-193,-752,-140,1,0,7
2854,06/05/2011,12581,12759,12580,12639,541,210,38,789,58,0,1,7
2855,09/05/2011,12638,12722,12620,12685,970,36,-268,738,47,0,1,8
2856,10/05/2011,12685,12781,12682,12760,462,330,-28,764,75,0,1,8
2857,11/05/2011,12746,12748,12577,12630,-263,-291,-326,-880,-116,1,0,8
2858,12/05/2011,12630,12719,12537,12696,87,157,151,395,66,0,1,8
2859,13/05/2011,12696,12714,12543,12596,236,49,-25,260,-100,0,0,8
2860,16/05/2011,12595,12643,12531,12548,160,-67,14,107,-47,0,0,7
2861,17/05/2011,12541,12541,12379,12480,130,-80,-175,-125,-61,1,0,7
2862,18/05/2011,12472,12571,12443,12560,-55,60,290,295,88,0,1,8
2863,19/05/2011,12562,12634,12534,12605,432,-343,75,164,43,0,1,8
2864,20/05/2011,12605,12605,12486,12512,-115,1260,208,1353,-93,0,0,8
2865,23/05/2011,12511,12511,12332,12381,-185,-366,-98,-649,-130,1,0,7
2866,24/05/2011,12382,12423,12350,12356,233,-403,-26,-196,-26,1,0,7
2867,25/05/2011,12356,12440,12310,12395,-353,43,94,-216,39,0,0,7
2868,26/05/2011,12392,12442,12318,12403,-307,-229,-30,-566,11,0,0,6
2869,27/05/2011,12398,12484,12398,12442,252,99,107,458,44,0,1,5
2870,31/05/2011,12443,12574,12443,12570,481,-128,167,520,127,0,1,6
2871,01/06/2011,12569,12570,12282,12290,395,230,-343,282,-279,0,0,7
2872,02/06/2011,12290,12307,12190,12249,-260,298,-204,-166,-41,1,0,6
2873,03/06/2011,12248,12248,12104,12151,343,56,-284,115,-97,0,0,6
2874,06/06/2011,12151,12152,12071,12090,-115,112,-169,-172,-61,1,0,5
2875,07/06/2011,12090,12179,12067,12071,-75,-691,-333,-1099,-19,1,0,6
2876,08/06/2011,12066,12098,12024,12049,161,-435,195,-79,-17,1,0,6
2877,09/06/2011,12050,12183,12049,12124,579,158,-16,721,74,0,1,6
2878,10/06/2011,12124,12125,11937,11952,139,-166,-100,-127,-172,1,0,7
2879,13/06/2011,11945,12012,11918,11953,597,-191,383,789,8,0,1,8
2880,14/06/2011,11951,12121,11951,12076,99,59,-199,-41,125,0,0,8
2881,15/06/2011,12075,12075,11862,11897,-676,-319,-342,-1337,-178,1,0,7
2882,16/06/2011,11896,11990,11876,11962,130,212,166,508,66,0,1,8
2883,17/06/2011,11963,12073,11962,12004,-90,191,6,107,41,0,1,8
2884,20/06/2011,12004,12100,11971,12080,-73,-46,72,-47,76,0,0,9
2885,21/06/2011,12081,12217,12081,12190,94,-435,-229,-570,109,0,0,8
2886,22/06/2011,12190,12208,12106,12110,-86,50,-331,-367,-80,1,0,7
2887,23/06/2011,12108,12109,11875,12050,-237,-121,48,-310,-58,1,0,7
2888,24/06/2011,12049,12057,11925,11935,-128,-383,290,-221,-114,1,0,7
2889,27/06/2011,11935,12099,11934,12044,139,129,56,324,109,0,1,7
2890,28/06/2011,12044,12190,12042,12189,399,-273,640,766,145,0,1,7
2891,29/06/2011,12188,12284,12176,12261,-387,79,57,-251,73,0,0,8
2892,30/06/2011,12262,12427,12262,12414,92,14,153,259,152,0,1,7
2893,01/07/2011,12414,12596,12404,12583,259,246,183,688,169,0,1,7
2894,05/07/2011,12570,12602,12541,12570,250,0,0,250,0,0,0,7
2895,06/07/2011,12562,12643,12539,12626,466,92,-21,537,64,0,1,7
2896,07/07/2011,12627,12754,12627,12720,339,82,93,514,93,0,1,8
2897,08/07/2011,12718,12718,12567,12657,-160,-180,-61,-401,-61,1,0,8
2898,11/07/2011,12656,12656,12470,12506,-347,-255,-255,-857,-150,1,0,8
2899,12/07/2011,12506,12571,12447,12447,1023,-90,255,1188,-59,0,0,8
2900,13/07/2011,12447,12611,12447,12492,-275,318,-81,-38,45,0,0,7
2901,14/07/2011,12492,12582,12414,12437,121,-242,-57,-178,-55,1,0,6
2902,15/07/2011,12437,12505,12406,12480,-580,-1214,-304,-2098,43,0,0,7
2903,18/07/2011,12475,12475,12296,12385,218,243,177,638,-90,0,0,6
2904,19/07/2011,12386,12608,12386,12587,147,333,106,586,201,0,1,5
2905,20/07/2011,12584,12604,12547,12572,275,111,55,441,-12,0,0,6
2906,21/07/2011,12567,12751,12567,12724,417,-274,-18,125,157,0,1,5
2907,22/07/2011,12725,12741,12644,12681,-642,711,-45,24,-44,0,0,5
2908,25/07/2011,12680,12680,12536,12593,-173,172,-157,-158,-87,1,0,4
2909,26/07/2011,12592,12593,12489,12501,802,-141,300,961,-91,0,0,4
2910,27/07/2011,12498,12499,12290,12303,88,456,-9,535,-195,0,0,4
2911,28/07/2011,12302,12385,12227,12240,-196,-290,-357,-843,-62,1,0,4
2912,29/07/2011,12239,12243,12084,12143,-174,-211,-174,-559,-96,1,0,4
2913,01/08/2011,12144,12282,11998,12132,8,-95,8,-79,-12,1,0,5
2914,02/08/2011,12130,12130,11866,11867,-287,-120,-287,-694,-263,1,0,6
2915,03/08/2011,11864,11905,11700,11896,-183,393,-183,27,32,0,1,6
2916,04/08/2011,11894,11894,11372,11384,-510,-402,-510,-1422,-510,1,0,7
2917,05/08/2011,11384,11555,11139,11445,61,-457,61,-335,61,0,0,7
2918,08/08/2011,11434,11434,10810,10810,-624,-624,-624,-1872,-624,1,0,7
2919,09/08/2011,10811,11244,10604,11240,429,429,429,1287,429,0,1,7
2920,10/08/2011,11228,11228,10686,10720,-508,-508,-508,-1524,-508,1,0,8
2921,11/08/2011,10730,11279,10730,11143,413,413,413,1239,413,0,1,9
2922,12/08/2011,11144,11347,11142,11269,126,171,39,336,125,0,1,9
2923,15/08/2011,11270,11485,11270,11483,63,-246,4,-179,213,0,0,9
2924,16/08/2011,11480,11488,11293,11406,-41,188,394,541,-74,0,0,8
2925,17/08/2011,11392,11530,11322,11410,2,53,224,279,18,0,1,7
2926,18/08/2011,11406,11406,10882,10991,-404,-486,-415,-1305,-415,1,0,7
2927,19/08/2011,10990,11086,10801,10818,-260,-172,151,-281,-172,1,0,7
2928,22/08/2011,10820,11021,10820,10855,476,35,35,546,35,0,1,8
2929,23/08/2011,10855,11177,10854,11177,158,322,199,679,322,0,1,8
2930,24/08/2011,11176,11332,11113,11321,881,89,200,1170,145,0,1,8
2931,25/08/2011,11321,11406,11107,11150,-237,-257,-489,-983,-171,1,0,8
2932,26/08/2011,11150,11326,10929,11284,81,96,51,228,134,0,1,8
2933,29/08/2011,11287,11542,11287,11539,-388,229,276,117,252,0,1,8
2934,30/08/2011,11532,11630,11429,11560,85,92,28,205,28,0,1,9
2935,31/08/2011,11560,11713,11528,11614,159,147,54,360,54,0,1,10
2936,01/09/2011,11613,11717,11488,11494,-478,-180,-119,-777,-119,1,0,10
2937,02/09/2011,11492,11492,11211,11240,-226,-221,-281,-728,-252,1,0,10
2938,06/09/2011,11237,11238,10932,11139,78,-93,-323,-338,-98,1,0,10
2939,07/09/2011,11138,11415,11138,11415,453,504,190,1147,277,0,1,10
2940,08/09/2011,11415,11477,11284,11296,-307,259,-32,-80,-119,1,0,10
2941,09/09/2011,11295,11295,10936,10992,-100,143,-336,-293,-303,1,0,10
2942,12/09/2011,10990,11062,10825,11061,36,71,71,178,71,0,1,10
2943,13/09/2011,11055,11141,10987,11106,-139,51,51,-37,51,0,0,10
2944,14/09/2011,11107,11387,10994,11247,325,184,103,612,140,0,1,9
2945,15/09/2011,11248,11433,11248,11433,439,39,-267,211,185,0,1,9
2946,16/09/2011,11434,11532,11407,11509,5,454,75,534,75,0,1,9
2947,19/09/2011,11507,11507,11255,11401,-106,-121,41,-186,-106,1,0,9
2948,20/09/2011,11402,11550,11374,11409,7,-627,-224,-844,7,0,0,9
2949,21/09/2011,11409,11448,11117,11125,-293,-443,227,-509,-284,1,0,8
2950,22/09/2011,11122,11122,10597,10734,-355,-388,-289,-1032,-388,1,0,8
2951,23/09/2011,10733,10808,10639,10772,-22,188,-22,144,39,0,1,8
2952,26/09/2011,10772,11058,10772,11044,272,-488,176,-40,272,0,0,8
2953,27/09/2011,11045,11369,11045,11191,291,-75,146,362,146,0,1,7
2954,28/09/2011,11189,11317,10997,11011,289,-143,0,146,-178,0,0,8
2955,29/09/2011,11013,11271,10966,11154,504,373,139,1016,141,0,1,7
2956,30/09/2011,11152,11152,10910,10913,-441,-302,-75,-818,-239,1,0,7
2957,03/10/2011,10912,10979,10653,10655,-350,-257,-84,-691,-257,1,0,7
2958,04/10/2011,10651,10825,10404,10809,158,155,158,471,158,0,1,7
2959,05/10/2011,10800,10951,10738,10940,130,592,70,792,140,0,1,8
2960,06/10/2011,10940,11133,10859,11123,210,231,526,967,183,0,1,8
2961,07/10/2011,11123,11232,11051,11103,136,188,-331,-7,-20,1,0,8
2962,10/10/2011,11105,11433,11105,11433,261,399,413,1073,328,0,1,8
2963,11/10/2011,11433,11448,11366,11416,84,56,-17,123,-17,0,0,9
2964,12/10/2011,11417,11625,11417,11519,102,102,102,306,102,0,1,8
2965,13/10/2011,11518,11518,11378,11478,-46,-19,-71,-136,-40,1,0,9
2966,14/10/2011,11479,11647,11479,11644,466,165,165,796,165,0,1,9
2967,17/10/2011,11643,11643,11378,11397,-298,-246,-246,-790,-246,1,0,9
2968,18/10/2011,11396,11653,11296,11577,575,476,313,1364,181,0,1,9
2969,19/10/2011,11578,11634,11469,11505,-11,95,75,159,-73,0,0,9
2970,20/10/2011,11502,11581,11391,11542,129,430,240,799,40,0,1,8
2971,21/10/2011,11543,11812,11543,11809,100,1079,240,1419,266,0,1,8
2972,24/10/2011,11808,11941,11806,11914,173,-44,-44,85,106,0,1,8
2973,25/10/2011,11913,11913,11682,11707,-36,13,13,-10,-206,1,0,8
2974,26/10/2011,11708,11891,11694,11869,369,-36,24,357,161,0,1,9
2975,27/10/2011,11872,12284,11872,12209,399,408,350,1157,337,0,1,9
2976,28/10/2011,12207,12252,12164,12231,-31,24,24,17,24,0,1,9
2977,31/10/2011,12229,12229,11954,11955,-274,-274,-274,-822,-274,1,0,9
2978,01/11/2011,11952,11952,11630,11658,87,-440,-392,-745,-294,1,0,9
2979,02/11/2011,11658,11877,11658,11836,-488,307,129,-52,178,0,0,9
2980,03/11/2011,11836,12066,11835,12044,-357,-87,-145,-589,208,0,0,9
2981,04/11/2011,12043,12044,11850,11983,120,380,-179,321,-60,0,0,8
2982,07/11/2011,11983,12074,11881,12068,11,140,132,283,85,0,1,7
2983,08/11/2011,12056,12188,12002,12170,114,347,313,774,114,0,1,7
2984,09/11/2011,12166,12166,11737,11781,-385,-394,-393,-1172,-385,1,0,7
2985,10/11/2011,11780,11961,11780,11894,547,124,70,741,114,0,1,7
2986,11/11/2011,11896,12180,11896,12154,608,397,391,1396,258,0,1,7
2987,14/11/2011,12153,12171,12027,12079,1,-478,43,-434,-74,1,0,7
2988,15/11/2011,12078,12165,12001,12096,161,1071,313,1545,18,0,1,7
2989,16/11/2011,12085,12109,11891,11906,-266,59,-51,-258,-179,1,0,7
2990,17/11/2011,11906,11948,11676,11771,-408,-1016,65,-1359,-135,1,0,8
2991,18/11/2011,11769,11855,11756,11796,-12,-318,27,-303,27,0,0,9
2992,21/11/2011,11796,11796,11454,11547,-55,-259,-249,-563,-249,1,0,9
2993,22/11/2011,11542,11572,11434,11494,42,-337,-48,-343,-48,1,0,9
2994,23/11/2011,11493,11493,11258,11258,-239,205,-239,-273,-235,1,0,9
2995,25/11/2011,11252,11362,11231,11232,-20,678,-20,638,-20,0,0,9
2996,28/11/2011,11232,11562,11232,11523,291,409,291,991,291,0,1,8
2997,29/11/2011,11523,11624,11517,11556,476,759,362,1597,33,0,1,8
2998,30/11/2011,11559,12046,11559,12046,487,410,479,1376,487,0,1,8
2999,01/12/2011,12046,12063,11975,12020,-26,-26,-34,-86,-26,1,0,8
3000,02/12/2011,12022,12147,12007,12019,80,101,101,282,-3,0,0,8
3001,05/12/2011,12022,12186,12022,12098,76,178,76,330,76,0,1,7
3002,06/12/2011,12098,12216,12077,12150,52,120,104,276,52,0,1,8
3003,07/12/2011,12144,12258,12060,12196,52,-19,104,137,52,0,1,8
3004,08/12/2011,12196,12196,11966,11998,39,-298,-190,-449,-198,1,0,8
3005,09/12/2011,11996,12213,11996,12184,518,646,337,1501,188,0,1,8
3006,12/12/2011,12181,12181,11941,12021,-73,-73,-272,-418,-160,1,0,9
3007,13/12/2011,12019,12148,11904,11955,-311,62,-245,-494,-64,1,0,9
3008,14/12/2011,11950,11950,11786,11824,-618,-151,-85,-854,-126,1,0,9
3009,15/12/2011,11825,11968,11825,11869,-77,44,379,346,44,0,1,9
3010,16/12/2011,11870,11968,11819,11866,97,127,101,325,-4,0,0,9
3011,19/12/2011,11866,11926,11735,11766,268,347,229,844,-100,0,0,9
3012,20/12/2011,11769,12117,11769,12104,597,580,379,1556,335,0,1,8
3013,21/12/2011,12104,12120,11999,12108,-52,-237,-17,-306,4,0,0,8
3014,22/12/2011,12108,12183,12107,12170,6,-116,-224,-334,62,0,0,7
3015,23/12/2011,12170,12297,12170,12294,-65,107,154,196,124,0,1,6
3016,27/12/2011,12294,12328,12270,12291,474,-3,-3,468,-3,0,0,6
3017,28/12/2011,12289,12299,12140,12151,-143,-138,-261,-542,-138,1,0,5
3018,29/12/2011,12152,12294,12152,12287,383,471,101,955,135,0,1,5
3019,30/12/2011,12286,12290,12214,12218,-68,-298,-21,-387,-68,1,0,5
3020,03/01/2012,12221,12480,12221,12397,209,1,236,446,176,0,1,5
3021,04/01/2012,12392,12430,12337,12418,269,-430,-44,-205,26,0,0,6
3022,05/01/2012,12418,12436,12284,12416,-581,531,294,244,-2,0,0,6
3023,06/01/2012,12408,12415,12332,12360,-68,-119,-172,-359,-48,1,0,5
3024,09/01/2012,12359,12409,12334,12393,508,143,-67,584,34,0,1,6
3025,10/01/2012,12394,12515,12394,12462,230,862,-254,838,68,0,1,7
3026,11/01/2012,12460,12463,12399,12450,-209,343,342,476,-10,0,0,7
3027,12/01/2012,12450,12484,12385,12471,312,-56,-156,100,21,0,1,7
3028,13/01/2012,12470,12470,12312,12422,-131,0,111,-20,-48,1,0,7
3029,17/01/2012,12423,12574,12423,12482,423,570,-32,961,59,0,1,7
3030,18/01/2012,12475,12582,12453,12579,-131,184,363,416,104,0,1,7
3031,19/01/2012,12578,12626,12564,12624,-250,58,-493,-685,46,0,0,7
3032,20/01/2012,12624,12720,12621,12720,96,-18,-148,-70,96,0,0,7
3033,23/01/2012,12720,12764,12666,12709,491,105,64,660,-11,0,0,7
3034,24/01/2012,12708,12708,12614,12676,-883,-695,-466,-2044,-32,1,0,6
3035,25/01/2012,12674,12778,12580,12759,721,150,67,938,85,0,1,6
3036,26/01/2012,12757,12842,12695,12735,-494,-63,-137,-694,-22,1,0,6
3037,27/01/2012,12734,12734,12631,12660,316,180,-148,348,-74,0,0,7
3038,30/01/2012,12659,12659,12529,12654,311,471,132,914,-5,0,0,6
3039,31/01/2012,12655,12720,12567,12633,-305,-104,-176,-585,-22,1,0,5
3040,01/02/2012,12633,12785,12633,12716,-57,255,124,322,83,0,1,5
3041,02/02/2012,12716,12742,12676,12705,-21,-75,-112,-208,-11,1,0,5
3042,03/02/2012,12705,12870,12705,12862,422,324,420,1166,157,0,1,6
3043,06/02/2012,12861,12861,12793,12845,333,86,158,577,-16,0,0,7
3044,07/02/2012,12844,12904,12783,12878,146,-293,-264,-411,34,0,0,7
3045,08/02/2012,12866,12894,12818,12884,-382,-621,-154,-1157,18,0,0,6
3046,09/02/2012,12884,12925,12846,12890,-437,-158,-65,-660,6,0,0,5
3047,10/02/2012,12890,12890,12744,12801,-65,-318,-148,-531,-89,1,0,4
3048,13/02/2012,12799,12888,12799,12874,-1,-98,189,90,75,0,1,5
3049,14/02/2012,12872,12879,12787,12878,417,207,151,775,6,0,1,6
3050,15/02/2012,12865,12900,12754,12781,-392,-252,172,-472,-84,1,0,6
3051,16/02/2012,12780,12914,12780,12904,-607,-177,-22,-806,124,0,0,6
3052,17/02/2012,12903,12968,12903,12950,-246,-150,-31,-427,47,0,0,5
3053,21/02/2012,12949,13005,12926,12966,-243,868,-163,462,17,0,1,4
3054,22/02/2012,12966,12978,12915,12939,-102,43,-26,-85,-27,1,0,5
3055,23/02/2012,12937,12996,12883,12985,625,-3,217,839,48,0,1,6
3056,24/02/2012,12981,13014,12951,12983,-158,52,-120,-226,2,0,0,7
3057,27/02/2012,12981,13028,12883,12982,-49,327,-236,42,1,0,1,7
3058,28/02/2012,12977,13022,12953,13005,795,223,351,1369,28,0,1,7
3059,29/02/2012,13005,13056,12930,12952,341,496,123,960,-53,0,0,7
3060,01/03/2012,12952,13033,12943,12980,160,-409,-142,-391,28,0,0,6
3061,02/03/2012,12981,12998,12928,12978,80,-98,55,37,-3,0,0,5
3062,05/03/2012,12977,12977,12884,12963,-160,-479,-26,-665,-14,1,0,5
3063,06/03/2012,12959,12959,12735,12759,-135,-8,-341,-484,-200,1,0,6
3064,07/03/2012,12756,12858,12752,12837,76,-381,31,-274,81,0,0,6
3065,08/03/2012,12836,12937,12836,12908,-337,83,77,-177,72,0,0,5
3066,09/03/2012,12909,12969,12906,12922,99,-300,197,-4,13,0,0,4
3067,12/03/2012,12921,12976,12920,12960,-59,250,173,364,39,0,1,4
3068,13/03/2012,12953,13180,12953,13178,505,55,820,1380,225,0,1,4
3069,14/03/2012,13177,13221,13166,13194,197,-3,-82,112,17,0,1,4
3070,15/03/2012,13193,13254,13170,13253,381,81,234,696,60,0,1,5
3071,16/03/2012,13254,13289,13232,13233,-420,99,13,-308,-21,1,0,6
3072,19/03/2012,13232,13270,13209,13239,-318,154,7,-157,7,0,0,7
3073,20/03/2012,13238,13238,13123,13170,2,-167,-125,-290,-68,1,0,6
3074,21/03/2012,13171,13190,13113,13125,135,-293,-121,-279,-46,1,0,6
3075,22/03/2012,13124,13124,13017,13046,154,-179,-78,-103,-78,1,0,7
3076,23/03/2012,13046,13100,13003,13081,-351,-52,180,-223,35,0,0,8
3077,26/03/2012,13083,13244,13082,13242,226,285,230,741,159,0,1,8
3078,27/03/2012,13242,13265,13194,13198,-42,-472,-192,-706,-44,1,0,8
3079,28/03/2012,13195,13213,13069,13126,-314,-256,-86,-656,-69,1,0,8
3080,29/03/2012,13126,13152,13033,13146,60,590,-138,512,20,0,1,8
3081,30/03/2012,13148,13224,13148,13212,216,-31,84,269,64,0,1,8
3082,02/04/2012,13211,13297,13154,13264,-25,105,18,98,53,0,1,8
3083,03/04/2012,13259,13265,13131,13200,-180,-331,-335,-846,-59,1,0,9
3084,04/04/2012,13198,13198,13021,13075,-659,-492,-540,-1691,-123,1,0,9
3085,05/04/2012,13067,13088,13012,13060,78,-109,98,67,-7,0,0,9
3086,09/04/2012,13058,13058,12904,12930,-86,-95,-128,-309,-128,1,0,8
3087,10/04/2012,12929,12930,12711,12716,-156,-167,-317,-640,-213,1,0,9
3088,11/04/2012,12717,12845,12717,12805,-520,87,88,-345,88,0,0,9
3089,12/04/2012,12806,12987,12806,12987,329,-13,181,497,181,0,1,8
3090,13/04/2012,12986,12986,12845,12850,152,375,81,608,-136,0,0,8
3091,16/04/2012,12851,12987,12851,12921,190,27,201,418,70,0,1,7
3092,17/04/2012,12922,13131,12922,13116,844,85,92,1021,194,0,1,7
3093,18/04/2012,13115,13115,13028,13033,-82,-375,-62,-519,-82,1,0,7
3094,19/04/2012,13029,13080,12897,12964,-177,20,-4,-161,-65,1,0,7
3095,20/04/2012,12964,13082,12964,13029,-162,27,602,467,65,0,1,7
3096,23/04/2012,13028,13028,12846,12927,-9,86,75,152,-101,0,0,8
3097,24/04/2012,12928,13050,12926,13002,-127,2,173,48,74,0,1,7
3098,25/04/2012,12998,13106,12994,13091,522,-345,492,669,93,0,1,7
3099,26/04/2012,13090,13228,13076,13205,393,53,-27,419,115,0,1,8
3100,27/04/2012,13205,13267,13192,13228,51,-274,-49,-272,23,0,0,8
3101,30/04/2012,13228,13229,13176,13214,-27,-101,29,-99,-14,1,0,8
3102,01/05/2012,13214,13339,13175,13279,17,52,122,191,65,0,1,8
3103,02/05/2012,13278,13278,13192,13269,-614,-443,-419,-1476,-9,1,0,8
3104,03/05/2012,13268,13284,13176,13207,105,9,54,168,-61,0,0,8
3105,04/05/2012,13205,13205,13022,13038,365,-155,-82,128,-167,0,0,7
3106,07/05/2012,13036,13049,12970,13008,-86,-166,-304,-556,-28,1,0,6
3107,08/05/2012,13001,13001,12810,12932,130,244,-58,316,-69,0,0,7
3108,09/05/2012,12922,12922,12748,12835,-43,-167,190,-20,-87,1,0,6
3109,10/05/2012,12832,12932,12820,12855,121,23,23,167,23,0,1,6
3110,11/05/2012,12852,12918,12779,12821,172,469,-31,610,-31,0,0,6
3111,14/05/2012,12818,12819,12662,12695,385,12,50,447,-123,0,0,6
3112,15/05/2012,12695,12758,12608,12632,-63,1581,-63,1455,-63,0,0,5
3113,16/05/2012,12617,12723,12597,12599,-349,1177,-18,810,-18,0,0,4
3114,17/05/2012,12598,12611,12440,12442,-78,-386,-156,-620,-156,1,0,3
3115,18/05/2012,12443,12493,12337,12369,-74,368,-74,220,-74,0,0,4
3116,21/05/2012,12369,12508,12368,12504,135,314,135,584,135,0,1,4
3117,22/05/2012,12505,12576,12447,12503,48,209,-21,236,-2,0,0,4
3118,23/05/2012,12502,12508,12312,12496,-369,-246,-94,-709,-6,1,0,4
3119,24/05/2012,12492,12540,12420,12530,219,-366,302,155,38,0,1,4
3120,25/05/2012,12531,12533,12422,12455,-356,181,52,-123,-76,1,0,4
3121,29/05/2012,12455,12612,12455,12581,829,290,77,1196,126,0,1,5
3122,30/05/2012,12579,12579,12396,12420,347,-312,-403,-368,-159,1,0,6
3123,31/05/2012,12414,12490,12316,12394,-198,-307,28,-477,-20,1,0,7
3124,01/06/2012,12392,12392,12108,12119,-181,-27,-373,-581,-273,1,0,8
3125,04/06/2012,12120,12144,12035,12102,24,-423,-18,-417,-18,1,0,8
3126,05/06/2012,12101,12148,12072,12128,679,-126,459,1012,27,0,1,9
3127,06/06/2012,12125,12415,12125,12415,360,196,-107,449,290,0,1,9
3128,07/06/2012,12416,12555,12416,12461,881,-125,45,801,45,0,1,10
3129,08/06/2012,12461,12554,12398,12554,262,-6,274,530,93,0,1,10
3130,11/06/2012,12554,12650,12398,12411,274,-122,-143,9,-143,0,0,10
3131,12/06/2012,12412,12577,12412,12574,858,-17,-59,782,162,0,1,9
3132,13/06/2012,12566,12598,12454,12496,3,75,-70,8,-70,0,0,9
3133,14/06/2012,12498,12699,12498,12652,-18,260,162,404,154,0,1,8
3134,15/06/2012,12652,12775,12651,12767,-242,-64,85,-221,115,0,0,8
3135,18/06/2012,12767,12782,12696,12742,-42,89,-18,29,-25,0,0,7
3136,19/06/2012,12745,12899,12744,12837,-210,208,-44,-46,92,0,0,6
3137,20/06/2012,12837,12877,12745,12824,-887,-3,-89,-979,-13,1,0,5
3138,21/06/2012,12823,12857,12562,12574,-565,-274,-228,-1067,-249,1,0,5
3139,22/06/2012,12575,12674,12575,12641,600,285,329,1214,66,0,1,5
3140,25/06/2012,12640,12640,12458,12503,-151,-80,-10,-241,-137,1,0,5
3141,26/06/2012,12504,12576,12452,12535,45,273,31,349,31,0,1,6
3142,27/06/2012,12533,12647,12533,12627,-67,92,-703,-678,94,0,0,6
3143,28/06/2012,12626,12626,12450,12602,689,-25,-101,563,-24,0,0,6
3144,29/06/2012,12605,12880,12604,12880,699,715,512,1926,275,0,1,5
3145,02/07/2012,12880,12902,12796,12871,-459,-586,-375,-1420,-9,1,0,6
3146,03/07/2012,12868,12946,12845,12944,-927,-758,-391,-2076,76,0,0,7
3147,05/07/2012,12942,12961,12852,12897,-920,-25,-144,-1089,-45,1,0,7
3148,06/07/2012,12889,12889,12703,12772,-582,-309,-34,-925,-117,1,0,7
3149,09/07/2012,12772,12772,12687,12736,160,54,-72,142,-36,0,0,7
3150,10/07/2012,12734,12830,12607,12653,-339,-136,-96,-571,-81,1,0,6
3151,11/07/2012,12653,12662,12534,12604,118,52,-555,-385,-49,1,0,6
3152,12/07/2012,12603,12631,12492,12573,-272,-8,79,-201,-30,1,0,6
3153,13/07/2012,12574,12785,12573,12777,-338,315,405,382,203,0,1,7
3154,16/07/2012,12776,12780,12690,12727,162,-191,-222,-251,-49,1,0,8
3155,17/07/2012,12729,12829,12645,12806,223,270,33,526,77,0,1,8
3156,18/07/2012,12797,12922,12755,12909,196,-14,-70,112,112,0,1,8
3157,19/07/2012,12910,12978,12890,12943,33,-351,33,-285,33,0,0,9
3158,20/07/2012,12943,12943,12810,12823,-120,-309,-73,-502,-120,1,0,8
3159,23/07/2012,12820,12820,12583,12722,-863,-88,-132,-1083,-98,1,0,8
3160,24/07/2012,12721,12730,12522,12617,-141,-39,-142,-322,-104,1,0,9
3161,25/07/2012,12618,12733,12618,12676,-355,-465,-267,-1087,58,0,0,9
3162,26/07/2012,12681,12931,12681,12888,92,57,21,170,207,0,1,8
3163,27/07/2012,12889,13118,12888,13076,393,356,283,1032,187,0,1,8
3164,30/07/2012,13075,13129,13043,13073,-480,68,-40,-452,-2,1,0,8
3165,31/07/2012,13072,13083,13006,13009,-196,-156,104,-248,-63,1,0,8
3166,01/08/2012,13008,13075,12951,12976,-301,18,-176,-459,-32,1,0,8
3167,02/08/2012,12970,12970,12779,12879,-14,-55,109,40,-91,0,0,8
3168,03/08/2012,12885,13133,12885,13096,191,108,-36,263,211,0,1,8
3169,06/08/2012,13100,13187,13100,13118,-642,-6,1,-647,18,0,0,8
3170,07/08/2012,13119,13216,13118,13169,-558,-37,261,-334,50,0,0,7
3171,08/08/2012,13158,13203,13115,13176,-379,181,86,-112,18,0,0,6
3172,09/08/2012,13175,13200,13125,13165,-757,26,-875,-1606,-10,1,0,6
3173,10/08/2012,13163,13208,13095,13208,202,-537,-86,-421,45,0,0,6
3174,13/08/2012,13205,13205,13113,13169,-95,-308,326,-77,-36,1,0,5
3175,14/08/2012,13168,13223,13142,13172,47,-479,13,-419,4,0,0,5
3176,15/08/2012,13158,13193,13138,13165,848,29,-14,863,7,0,1,4
3177,16/08/2012,13163,13269,13146,13250,-355,209,-524,-670,87,0,0,4
3178,17/08/2012,13251,13281,13245,13275,-137,126,228,217,24,0,1,4
3179,20/08/2012,13275,13276,13230,13272,-158,22,203,67,-3,0,0,4
3180,21/08/2012,13272,13331,13187,13204,256,453,178,887,-68,0,0,4
3181,22/08/2012,13198,13205,13120,13173,260,733,423,1416,-25,0,0,4
3182,23/08/2012,13171,13171,13046,13058,-85,-53,95,-43,-113,1,0,4
3183,24/08/2012,13053,13176,13027,13158,108,-7,33,134,105,0,1,4
3184,27/08/2012,13158,13176,13116,13125,-392,28,-147,-511,-33,1,0,5
3185,28/08/2012,13123,13147,13081,13103,234,-206,870,898,-20,0,0,5
3186,29/08/2012,13104,13145,13081,13108,296,177,304,777,4,0,1,5
3187,30/08/2012,13101,13101,12979,13001,327,362,512,1201,-100,0,0,5
3188,31/08/2012,13003,13152,13003,13091,145,270,2,417,88,0,1,5
3189,04/09/2012,13092,13092,12977,13036,-202,-307,51,-458,-56,1,0,5
3190,05/09/2012,13036,13096,13019,13048,1,847,264,1112,12,0,1,6
3191,06/09/2012,13045,13294,13045,13292,173,179,16,368,247,0,1,7
3192,07/09/2012,13290,13320,13266,13307,-778,-122,-21,-921,17,0,0,8
3193,10/09/2012,13309,13324,13251,13254,-573,-477,-55,-1105,-55,1,0,7
3194,11/09/2012,13255,13354,13253,13323,384,531,66,981,68,0,1,7
3195,12/09/2012,13322,13374,13318,13333,-388,44,167,-177,11,0,0,7
3196,13/09/2012,13330,13573,13325,13540,-46,-80,210,84,210,0,1,7
3197,14/09/2012,13540,13653,13534,13593,12,28,47,87,53,0,1,7
3198,17/09/2012,13589,13593,13527,13553,-42,-126,227,59,-36,0,0,8
3199,18/09/2012,13552,13582,13518,13565,-99,169,162,232,13,0,1,7
3200,19/09/2012,13565,13626,13557,13578,-6,4,174,172,13,0,1,7
3201,20/09/2012,13575,13599,13503,13597,123,-172,-141,-190,22,0,0,7
3202,21/09/2012,13597,13647,13572,13580,-382,52,-84,-414,-17,1,0,6
3203,24/09/2012,13578,13602,13522,13559,265,-90,-83,92,-19,0,0,7
3204,25/09/2012,13560,13620,13457,13458,-80,224,-195,-51,-102,1,0,6
3205,26/09/2012,13459,13480,13407,13414,60,-93,72,39,-45,0,0,6
3206,27/09/2012,13414,13523,13414,13486,69,-244,-167,-342,72,0,0,6
3207,28/09/2012,13486,13488,13367,13437,880,-169,-461,250,-49,0,0,5
3208,01/10/2012,13438,13598,13438,13515,44,29,52,125,77,0,1,4
3209,02/10/2012,13515,13567,13425,13482,130,-221,431,340,-33,0,0,5
3210,03/10/2012,13479,13536,13439,13495,196,138,251,585,16,0,1,4
3211,04/10/2012,13495,13594,13495,13575,488,794,-137,1145,80,0,1,4
3212,05/10/2012,13569,13662,13569,13610,218,-82,174,310,41,0,1,5
3213,08/10/2012,13589,13610,13552,13584,-174,25,-197,-346,-5,1,0,5
3214,09/10/2012,13583,13592,13473,13474,-63,-224,-229,-516,-109,1,0,6
3215,10/10/2012,13474,13479,13328,13345,-120,-23,1,-142,-129,1,0,6
3216,11/10/2012,13346,13428,13326,13326,51,60,9,120,-20,0,0,7
3217,12/10/2012,13326,13401,13296,13329,45,730,-84,691,3,0,1,7
3218,15/10/2012,13330,13438,13326,13424,213,759,140,1112,94,0,1,8
3219,16/10/2012,13424,13556,13424,13552,657,-334,366,689,128,0,1,8
3220,17/10/2012,13540,13562,13469,13557,56,-345,-188,-477,17,0,0,9
3221,18/10/2012,13553,13589,13511,13549,18,-192,-188,-362,-4,1,0,8
3222,19/10/2012,13545,13546,13312,13344,-6,-121,-82,-209,-201,1,0,8
3223,22/10/2012,13344,13369,13235,13346,300,2,-112,190,2,0,1,8
3224,23/10/2012,13345,13345,13083,13102,-227,-263,-281,-771,-243,1,0,8
3225,24/10/2012,13104,13155,13064,13077,-123,1330,199,1406,-27,0,0,8
3226,25/10/2012,13080,13214,13017,13104,209,1044,209,1462,24,0,1,7
3227,26/10/2012,13104,13152,13040,13107,61,39,364,464,3,0,1,8
3228,31/10/2012,13107,13189,13052,13096,23,-95,-133,-205,-11,1,0,8
3229,01/11/2012,13099,13274,13099,13233,-8,188,134,314,134,0,1,8
3230,02/11/2012,13233,13290,13077,13093,-503,-290,12,-781,-140,1,0,8
3231,05/11/2012,13092,13141,13039,13112,-11,-109,24,-96,20,0,0,9
3232,06/11/2012,13113,13291,13113,13246,351,187,-369,169,133,0,1,8
3233,07/11/2012,13228,13228,12877,12933,-388,-357,-402,-1147,-295,1,0,8
3234,08/11/2012,12933,12980,12811,12811,-142,-84,166,-60,-122,1,0,8
3235,09/11/2012,12811,12890,12743,12815,4,-531,4,-523,4,0,0,8
3236,12/11/2012,12816,12861,12783,12815,158,925,-96,987,-1,0,0,8
3237,13/11/2012,12809,12898,12748,12756,64,-95,226,195,-53,0,0,7
3238,14/11/2012,12746,12798,12543,12571,-456,-494,-25,-975,-175,1,0,6
3239,15/11/2012,12571,12601,12497,12542,65,-495,-62,-492,-29,1,0,6
3240,16/11/2012,12542,12604,12472,12588,-50,254,-40,164,46,0,1,6
3241,19/11/2012,12590,12796,12590,12796,409,469,195,1073,206,0,1,6
3242,20/11/2012,12791,12809,12701,12788,199,214,-3,410,-3,0,0,7
3243,21/11/2012,12788,12846,12786,12837,206,81,130,417,49,0,1,6
3244,23/11/2012,12833,13012,12833,13010,537,309,55,901,177,0,1,6
3245,26/11/2012,13008,13008,12900,12967,-96,23,-41,-114,-41,1,0,6
3246,27/11/2012,12963,12980,12868,12878,-480,-237,-85,-802,-85,1,0,7
3247,28/11/2012,12876,12989,12765,12985,23,286,42,351,109,0,1,8
3248,29/11/2012,12977,13063,12962,13022,292,-311,148,129,45,0,1,9
3249,30/11/2012,13022,13054,12989,13026,-93,-128,148,-73,4,0,0,9
3250,03/12/2012,13028,13087,12959,12966,326,-194,-62,70,-62,0,0,8
3251,04/12/2012,12966,13022,12940,12952,-559,202,97,-260,-14,1,0,7
3252,05/12/2012,12949,13089,12923,13034,399,385,-33,751,85,0,1,7
3253,06/12/2012,13026,13077,13008,13074,364,417,141,922,48,0,1,8
3254,07/12/2012,13073,13157,13073,13155,-108,43,-26,-91,82,0,0,8
3255,10/12/2012,13155,13195,13139,13170,437,23,54,514,15,0,1,7
3256,11/12/2012,13170,13307,13170,13248,-326,-79,136,-269,78,0,0,7
3257,12/12/2012,13250,13329,13227,13246,-630,-43,264,-409,-4,1,0,6
3258,13/12/2012,13241,13264,13147,13171,-318,-211,-73,-602,-70,1,0,6
3259,14/12/2012,13171,13190,13118,13135,317,467,346,1130,-36,0,0,6
3260,17/12/2012,13135,13244,13135,13235,52,814,251,1117,100,0,1,6
3261,18/12/2012,13237,13366,13233,13351,209,-542,-203,-536,114,0,0,7
3262,19/12/2012,13351,13358,13252,13252,-233,-247,-301,-781,-99,1,0,6
3263,20/12/2012,13247,13315,13216,13312,469,-175,-427,-133,65,0,0,6
3264,21/12/2012,13310,13310,13122,13191,199,-136,14,77,-119,0,0,5
3265,24/12/2012,13190,13190,13129,13139,-463,650,-230,-43,-51,1,0,5
3266,26/12/2012,13139,13175,13077,13115,254,417,158,829,-24,0,0,5
3267,27/12/2012,13115,13142,12964,13096,25,-95,160,90,-19,0,0,5
3268,28/12/2012,13095,13096,12927,12938,-219,-74,-83,-376,-157,1,0,4
3269,31/12/2012,12938,13109,12884,13104,108,-625,275,-242,166,0,0,4
3270,02/01/2013,13104,13413,13104,13413,327,428,367,1122,309,0,1,4
3271,03/01/2013,13413,13431,13358,13391,450,-22,-22,406,-22,0,0,4
3272,04/01/2013,13391,13447,13376,13435,-95,280,307,492,44,0,1,4
3273,07/01/2013,13436,13436,13343,13384,450,92,-52,490,-52,0,0,4
3274,08/01/2013,13377,13377,13293,13329,26,445,-59,412,-48,0,0,4
3275,09/01/2013,13330,13417,13329,13390,-77,31,236,190,60,0,1,4
3276,10/01/2013,13392,13478,13382,13471,163,145,25,333,79,0,1,4
3277,11/01/2013,13472,13497,13440,13488,-455,254,89,-112,16,0,0,5
3278,14/01/2013,13488,13520,13460,13507,-46,318,17,289,19,0,1,5
3279,15/01/2013,13507,13546,13446,13535,-106,497,64,455,28,0,1,5
3280,16/01/2013,13535,13535,13469,13511,-415,53,15,-347,-24,1,0,6
3281,17/01/2013,13511,13634,13510,13596,354,322,229,905,85,0,1,6
3282,18/01/2013,13596,13650,13572,13650,-510,-27,197,-340,54,0,0,7
3283,22/01/2013,13650,13712,13623,13712,-165,-215,-33,-413,62,0,0,6
3284,23/01/2013,13712,13794,13710,13779,-505,-396,-324,-1225,67,0,0,6
3285,24/01/2013,13779,13880,13779,13825,260,-110,48,198,46,0,1,6
3286,25/01/2013,13825,13896,13825,13896,269,408,71,748,71,0,1,6
3287,28/01/2013,13896,13916,13863,13882,-887,-14,-14,-915,-14,1,0,6
3288,29/01/2013,13882,13970,13880,13954,-609,-148,-45,-802,72,0,0,7
3289,30/01/2013,13954,13966,13897,13910,270,66,25,361,-44,0,0,6
3290,31/01/2013,13910,13941,13861,13861,406,-504,-352,-450,-49,1,0,5
3291,01/02/2013,13861,14020,13861,14010,733,155,305,1193,149,0,1,5
3292,04/02/2013,14010,14010,13867,13880,75,-419,-130,-474,-130,1,0,5
3293,05/02/2013,13880,14014,13880,13979,109,316,45,470,99,0,1,6
3294,06/02/2013,13979,13992,13913,13986,380,-191,228,417,7,0,1,7
3295,07/02/2013,13986,13988,13852,13944,-50,153,327,430,-42,0,0,8
3296,08/02/2013,13944,14023,13944,13993,26,604,64,694,49,0,1,7
3297,11/02/2013,13993,13993,13940,13971,232,-141,50,141,-22,0,0,7
3298,12/02/2013,13971,14039,13969,14019,423,657,-161,919,48,0,1,6
3299,13/02/2013,14019,14029,13946,13983,536,142,-72,606,-36,0,0,7
3300,14/02/2013,13983,13990,13922,13973,513,-13,169,669,-10,0,0,7
3301,15/02/2013,13973,14002,13907,13982,260,497,423,1180,9,0,1,6
3302,19/02/2013,13982,14045,13978,14036,161,273,194,628,54,0,1,6
3303,20/02/2013,14036,14058,13919,13928,-131,-185,-34,-350,-108,1,0,6
3304,21/02/2013,13928,13928,13834,13881,-172,453,-205,76,-47,0,0,6
3305,22/02/2013,13881,14001,13881,14001,-73,314,63,304,120,0,1,5
3306,25/02/2013,14001,14082,13784,13784,36,375,205,616,-217,0,0,6
3307,26/02/2013,13784,13918,13784,13900,142,-79,116,179,116,0,1,5
3308,27/02/2013,13900,14105,13880,14075,868,-240,303,931,175,0,1,6
3309,28/02/2013,14075,14149,14050,14054,-95,92,28,25,-21,0,0,6
3310,01/03/2013,14054,14107,13938,14090,286,-137,36,185,36,0,1,6
3311,04/03/2013,14090,14128,14030,14128,-65,507,36,478,38,0,1,7
3312,05/03/2013,14128,14286,14128,14254,-212,192,15,-5,126,0,0,7
3313,06/03/2013,14254,14321,14253,14296,-920,42,161,-717,42,0,0,6
3314,07/03/2013,14296,14355,14296,14330,-998,18,13,-967,34,0,0,5
3315,08/03/2013,14330,14413,14330,14397,-532,48,48,-436,67,0,0,5
3316,11/03/2013,14397,14448,14373,14447,-270,-158,-25,-453,50,0,0,4
3317,12/03/2013,14447,14479,14412,14450,-998,-196,-196,-1390,3,0,0,4
3318,13/03/2013,14450,14473,14412,14455,-852,-33,-122,-1007,5,0,0,3
3319,14/03/2013,14455,14539,14455,14539,-366,98,16,-252,84,0,0,2
3320,15/03/2013,14539,14539,14470,14514,-711,-24,-161,-896,-25,1,0,2
3321,18/03/2013,14514,14522,14404,14452,116,52,43,211,-62,0,0,2
3322,19/03/2013,14452,14514,14382,14456,-174,-97,-434,-705,4,0,0,1
3323,20/03/2013,14456,14547,14456,14512,129,136,-198,67,56,0,1,1
3324,21/03/2013,14512,14512,14383,14422,-536,-457,-14,-1007,-90,1,0,2
3325,22/03/2013,14422,14520,14422,14512,364,695,85,1144,90,0,1,3
3326,25/03/2013,14512,14564,14395,14448,300,482,-616,166,-64,0,0,4
3327,26/03/2013,14448,14562,14448,14560,183,28,-13,198,112,0,1,4
3328,27/03/2013,14560,14560,14440,14526,510,311,89,910,-34,0,0,5
3329,28/03/2013,14526,14585,14521,14578,-432,399,-34,-67,52,0,0,5
3330,01/04/2013,14578,14606,14532,14573,124,-232,-234,-342,-5,1,0,5
3331,02/04/2013,14573,14684,14573,14662,261,59,18,338,89,0,1,5
3332,03/04/2013,14662,14683,14525,14550,-191,-522,-196,-909,-112,1,0,6
3333,04/04/2013,14550,14625,14539,14606,87,719,19,825,56,0,1,7
3334,05/04/2013,14606,14606,14434,14565,365,-112,-79,174,-41,0,0,7
3335,08/04/2013,14565,14614,14498,14614,-95,-409,-139,-643,49,0,0,6
3336,09/04/2013,14614,14716,14598,14674,-460,-199,-15,-674,60,0,0,5
3337,10/04/2013,14674,14827,14674,14802,-108,243,204,339,128,0,1,5
3338,11/04/2013,14802,14888,14785,14865,-852,23,16,-813,63,0,0,5
3339,12/04/2013,14865,14865,14791,14865,294,-262,0,32,0,0,0,5
3340,15/04/2013,14865,14865,14599,14599,-852,-447,-388,-1687,-266,1,0,5
3341,16/04/2013,14599,14762,14599,14757,193,298,-338,153,158,0,1,5
3342,17/04/2013,14757,14757,14561,14619,317,-86,-210,21,-138,0,0,5
3343,18/04/2013,14619,14650,14495,14537,60,-46,-336,-322,-82,1,0,4
3344,19/04/2013,14537,14554,14444,14548,41,-8,-95,-62,11,0,0,4
3345,22/04/2013,14548,14589,14458,14567,289,-131,-69,89,19,0,1,4
3346,23/04/2013,14567,14721,14554,14720,-352,-177,330,-199,153,0,0,5
3347,24/04/2013,14720,14747,14666,14676,-237,-29,-498,-764,-44,1,0,5
3348,25/04/2013,14676,14768,14666,14701,-388,144,179,-65,25,0,0,5
3349,26/04/2013,14701,14744,14685,14713,648,140,202,990,12,0,1,5
3350,29/04/2013,14713,14845,14713,14819,64,-312,-95,-343,106,0,0,6
3351,30/04/2013,14819,14840,14734,14840,-107,-1125,21,-1211,21,0,0,5
3352,01/05/2013,14840,14840,14687,14701,-181,-157,-139,-477,-139,1,0,4
3353,02/05/2013,14701,14835,14701,14832,210,497,124,831,131,0,1,5
3354,03/05/2013,14832,15010,14832,14974,135,427,282,844,142,0,1,5
3355,06/05/2013,14974,14989,14941,14969,270,108,104,482,-5,0,0,6
3356,07/05/2013,14969,15057,14969,15056,-207,383,47,223,87,0,1,5
3357,08/05/2013,15056,15107,15022,15105,309,-26,-26,257,49,0,1,6
3358,09/05/2013,15105,15145,15047,15083,197,-14,-14,169,-22,0,0,6
3359,10/05/2013,15083,15118,15038,15118,-207,85,-307,-429,35,0,0,6
3360,13/05/2013,15113,15113,15054,15092,-247,-394,-183,-824,-21,1,0,5
3361,14/05/2013,15092,15220,15089,15215,461,150,62,673,123,0,1,6
3362,15/05/2013,15212,15301,15175,15276,-611,373,-45,-283,64,0,0,7
3363,16/05/2013,15274,15302,15216,15233,-459,-586,-375,-1420,-41,1,0,6
3364,17/05/2013,15235,15357,15235,15354,146,-293,-264,-411,119,0,0,6
3365,20/05/2013,15348,15392,15314,15335,-459,43,43,-373,-13,1,0,5
3366,21/05/2013,15335,15434,15326,15388,105,58,297,460,53,0,1,6
3367,22/05/2013,15387,15542,15266,15307,-247,-234,-77,-558,-80,1,0,6
3368,23/05/2013,15301,15348,15180,15294,354,207,123,684,-7,0,0,6
3369,24/05/2013,15291,15307,15200,15303,-45,209,-196,-32,12,0,0,6
3370,28/05/2013,15307,15522,15307,15409,138,372,-178,332,102,0,1,6
3371,29/05/2013,15400,15400,15230,15303,-365,-407,238,-534,-97,1,0,6
3372,30/05/2013,15306,15399,15281,15324,639,156,621,1416,18,0,1,6
3373,31/05/2013,15322,15392,15116,15116,260,497,423,1180,-206,0,0,7
3374,03/06/2013,15124,15254,15124,15254,189,339,130,658,130,0,1,6
3375,04/06/2013,15255,15305,15101,15178,-302,-489,-132,-923,-77,1,0,7
3376,05/06/2013,15168,15169,14946,14961,-561,-881,-351,-1793,-207,1,0,7
3377,06/06/2013,14956,15041,14844,15041,121,1044,85,1250,85,0,1,7
3378,07/06/2013,15044,15256,15044,15248,84,433,204,721,204,0,1,7
3379,10/06/2013,15248,15301,15211,15239,119,52,-259,-88,-9,1,0,8
3380,11/06/2013,15231,15251,15086,15122,493,-503,-151,-161,-109,1,0,9
3381,12/06/2013,15130,15241,14981,14995,94,212,183,489,-135,0,0,9
3382,13/06/2013,14992,15202,14954,15176,433,93,181,707,184,0,1,8
3383,14/06/2013,15178,15206,15045,15070,-272,-686,187,-771,-108,1,0,8
3384,17/06/2013,15079,15262,15079,15180,432,168,73,673,101,0,1,9
3385,18/06/2013,15186,15340,15186,15318,108,28,-258,-122,132,0,0,9
3386,19/06/2013,15316,15322,15112,15112,-44,-124,-341,-509,-204,1,0,8
3387,20/06/2013,15106,15106,14732,14758,-841,-523,-394,-1758,-348,1,0,8
3388,21/06/2013,14761,14859,14688,14799,-239,-631,-239,-1109,38,0,0,8
3389,24/06/2013,14796,14796,14551,14660,-136,-83,-235,-454,-136,1,0,7
3390,25/06/2013,14670,14812,14670,14760,243,205,243,691,90,0,1,7
3391,26/06/2013,14770,14939,14770,14910,579,-792,51,-162,140,0,0,7
3392,27/06/2013,14921,15075,14921,15024,-127,690,701,1264,103,0,1,7
3393,28/06/2013,15017,15035,14885,14910,412,-549,-380,-517,-107,1,0,7
3394,01/07/2013,14912,15083,14912,14975,495,146,191,832,63,0,1,7
3395,02/07/2013,14975,15049,14870,14932,323,-17,21,327,-43,0,0,7
3396,03/07/2013,14924,15026,14859,14988,172,15,21,208,64,0,1,7
3397,05/07/2013,14996,15138,14971,15136,-39,260,405,626,140,0,1,7
3398,08/07/2013,15137,15263,15137,15225,88,184,251,523,88,0,1,7
3399,09/07/2013,15228,15320,15228,15300,-15,123,72,180,72,0,1,8
3400,10/07/2013,15298,15349,15259,15292,-6,-139,-6,-151,-6,1,0,8
3401,11/07/2013,15298,15484,15298,15461,213,96,251,560,163,0,1,8
3402,12/07/2013,15461,15498,15410,15464,-145,3,-21,-163,3,0,0,9
3403,15/07/2013,15460,15510,15456,15484,474,24,24,522,24,0,1,8
3404,16/07/2013,15485,15498,15416,15452,-420,-70,-70,-560,-33,1,0,8
3405,17/07/2013,15457,15502,15438,15470,-933,-381,-159,-1473,13,0,0,8
3406,18/07/2013,15466,15589,15466,15548,-217,-90,-71,-378,82,0,0,8
3407,19/07/2013,15524,15545,15492,15544,-366,-518,-311,-1195,20,0,0,7
3408,22/07/2013,15544,15576,15516,15546,327,-388,-269,-330,2,0,0,6
3409,23/07/2013,15547,15604,15544,15568,-112,-4,177,61,21,0,1,5
3410,24/07/2013,15577,15603,15497,15542,-102,-119,-324,-545,-35,1,0,5
3411,25/07/2013,15539,15560,15456,15556,-331,-112,-284,-727,17,0,0,5
3412,26/07/2013,15548,15561,15405,15559,-174,-239,-186,-599,11,0,0,4
3413,29/07/2013,15557,15557,15482,15522,-505,399,-574,-680,-35,1,0,4
3414,30/07/2013,15534,15594,15479,15521,-135,772,-316,321,-13,0,0,4
3415,31/07/2013,15529,15634,15493,15500,-23,156,149,282,-29,0,0,3
3416,01/08/2013,15504,15651,15504,15628,657,120,56,833,124,0,1,3
3417,02/08/2013,15628,15658,15559,15658,47,-313,-257,-523,30,0,0,4
3418,05/08/2013,15652,15655,15585,15612,-365,396,-131,-100,-40,1,0,4
3419,06/08/2013,15608,15608,15473,15519,296,-252,-539,-495,-89,1,0,5
3420,07/08/2013,15516,15516,15422,15471,-22,-447,-9,-478,-45,1,0,5
3421,08/08/2013,15477,15557,15419,15498,40,-109,21,-48,21,0,0,5
3422,09/08/2013,15497,15508,15347,15426,-232,-287,-185,-704,-71,1,0,5
3423,12/08/2013,15415,15442,15360,15420,-561,183,77,-301,5,0,0,6
3424,13/08/2013,15421,15504,15342,15451,-337,99,-69,-307,30,0,0,5
3425,14/08/2013,15448,15453,15317,15338,730,413,-9,1134,-110,0,0,5
3426,15/08/2013,15333,15333,15094,15112,-206,212,-207,-201,-221,1,0,5
3427,16/08/2013,15113,15140,15054,15082,99,-302,-31,-234,-31,1,0,5
3428,19/08/2013,15077,15106,15005,15011,-88,-58,-88,-234,-66,1,0,6
3429,20/08/2013,15012,15075,14992,15003,105,-661,105,-451,-9,1,0,6
3430,21/08/2013,14994,15020,14881,14898,-123,578,199,654,-96,0,0,6
3431,22/08/2013,14909,14989,14899,14964,55,232,55,342,55,0,1,5
3432,23/08/2013,14989,15026,14931,15010,-11,-191,8,-194,21,0,0,6
3433,26/08/2013,15015,15050,14945,14946,-369,-91,18,-442,-69,1,0,5
3434,27/08/2013,14939,14939,14765,14776,-257,142,-255,-370,-163,1,0,6
3435,28/08/2013,14771,14867,14760,14824,-481,-625,-25,-1131,53,0,0,7
3436,29/08/2013,14818,14916,14792,14841,489,685,580,1754,23,0,1,7
3437,30/08/2013,14844,14848,14762,14810,64,-104,-117,-157,-34,1,0,7
3438,03/09/2013,14802,14933,14778,14834,-195,-532,59,-668,32,0,0,7
3439,04/09/2013,14832,14957,14799,14931,-407,212,305,110,99,0,1,6
3440,05/09/2013,14930,14988,14923,14938,1432,205,-59,1578,8,0,1,6
3441,06/09/2013,14942,15010,14789,14922,-91,7,100,16,-20,0,0,7
3442,09/09/2013,14927,15088,14927,15063,478,-6,48,520,136,0,1,6
3443,10/09/2013,15067,15192,15067,15191,110,115,276,501,124,0,1,7
3444,11/09/2013,15194,15327,15194,15327,133,73,-125,81,133,0,1,7
3445,12/09/2013,15327,15345,15283,15301,120,-26,-26,68,-26,0,0,7
3446,13/09/2013,15313,15381,15313,15376,76,246,63,385,63,0,1,7
3447,16/09/2013,15381,15550,15381,15495,176,287,114,577,114,0,1,7
3448,17/09/2013,15503,15555,15503,15530,120,27,27,174,27,0,1,7
3449,18/09/2013,15533,15710,15470,15677,276,144,144,564,144,0,1,8
3450,19/09/2013,15678,15696,15626,15637,76,-41,-41,-6,-41,1,0,8
3451,20/09/2013,15635,15655,15448,15451,-184,-162,-143,-489,-184,1,0,8
3452,23/09/2013,15452,15467,15368,15401,309,36,110,455,-51,0,0,9
3453,24/09/2013,15402,15434,15327,15335,-361,733,0,372,-67,0,0,8
3454,25/09/2013,15339,15372,15253,15273,-234,14,-281,-501,-66,1,0,7
3455,26/09/2013,15274,15387,15274,15328,322,423,94,839,54,0,1,7
3456,27/09/2013,15318,15318,15212,15258,-402,-545,-199,-1146,-60,1,0,8
3457,30/09/2013,15250,15250,15087,15130,84,-826,74,-668,-120,1,0,8
3458,01/10/2013,15132,15208,15110,15192,-58,-75,199,66,60,0,1,8
3459,02/10/2013,15183,15183,15045,15133,-61,393,-50,282,-50,0,0,8
3460,03/10/2013,15127,15127,14947,14996,196,-102,110,204,-131,0,0,7
3461,04/10/2013,14995,15084,14972,15073,-78,37,78,37,78,0,1,6
3462,07/10/2013,15069,15069,14921,14936,-94,-233,-233,-560,-133,1,0,6
3463,08/10/2013,14938,14938,14774,14776,7,-186,205,26,-162,0,0,7
3464,09/10/2013,14778,14852,14719,14803,25,-123,39,-59,25,0,0,7
3465,10/10/2013,14806,15126,14806,15126,171,-210,-75,-114,320,0,0,6
3466,11/10/2013,15126,15237,15100,15237,-143,-60,182,-21,111,0,0,5
3467,14/10/2013,15231,15310,15136,15301,-173,261,198,286,70,0,1,4
3468,15/10/2013,15300,15302,15161,15168,-194,-132,-132,-458,-132,1,0,4
3469,16/10/2013,15171,15374,15171,15374,1009,226,1086,2321,203,0,1,4
3470,17/10/2013,15370,15376,15229,15372,315,-98,8,225,2,0,1,5
3471,18/10/2013,15372,15413,15322,15400,19,18,28,65,28,0,1,6
3472,21/10/2013,15401,15410,15363,15392,225,8,-9,224,-9,0,0,6
3473,22/10/2013,15394,15518,15394,15468,163,-175,-76,-88,74,0,0,5
3474,23/10/2013,15465,15466,15366,15413,-459,-73,-45,-577,-52,1,0,5
3475,24/10/2013,15415,15529,15414,15509,265,382,-119,528,94,0,1,6
3476,25/10/2013,15524,15571,15513,15570,219,12,46,277,46,0,1,7
3477,28/10/2013,15569,15599,15534,15569,-379,-101,-220,-700,0,0,0,8
3478,29/10/2013,15572,15683,15572,15680,-56,17,93,54,108,0,1,7
3479,30/10/2013,15681,15721,15574,15619,-378,-60,-344,-782,-62,1,0,7
3480,31/10/2013,15620,15652,15545,15546,327,-471,-179,-323,-74,1,0,7
3481,01/11/2013,15558,15649,15543,15616,-42,-75,326,209,58,0,1,7
3482,04/11/2013,15621,15659,15588,15639,250,31,329,610,18,0,1,7
3483,05/11/2013,15631,15652,15522,15618,281,-73,298,506,-13,0,0,8
3484,06/11/2013,15629,15750,15629,15747,11,-248,96,-141,118,0,0,8
3485,07/11/2013,15751,15798,15586,15594,4,-401,-71,-468,-157,1,0,7
3486,08/11/2013,15592,15764,15579,15762,379,-232,124,271,170,0,1,7
3487,11/11/2013,15759,15791,15737,15783,-209,-399,-223,-831,24,0,0,7
3488,12/11/2013,15773,15793,15708,15751,-209,199,-392,-402,-22,1,0,7
3489,13/11/2013,15740,15823,15672,15822,298,-255,-124,-81,82,0,0,7
3490,14/11/2013,15806,15885,15799,15876,-250,58,-493,-685,70,0,0,6
3491,15/11/2013,15876,15963,15876,15962,-217,-146,-165,-528,86,0,0,5
3492,18/11/2013,15963,16030,15942,15976,-269,-466,-392,-1127,13,0,0,4
3493,19/11/2013,15974,16026,15944,15967,-852,-752,-240,-1844,-7,1,0,3
3494,20/11/2013,15971,16017,15865,15901,-147,-189,24,-312,-70,1,0,4
3495,21/11/2013,15908,16016,15908,16010,365,-112,-79,174,102,0,1,5
3496,22/11/2013,16009,16069,15976,16065,-887,-1152,-221,-2260,56,0,0,5
3497,25/11/2013,16072,16110,16055,16073,-46,-5,35,-16,1,0,0,4
3498,26/11/2013,16071,16120,16071,16073,-382,-83,-15,-480,2,0,0,4
3499,27/11/2013,16073,16108,16057,16097,-415,-285,295,-405,24,0,0,3
3500,29/11/2013,16105,16175,16074,16086,-352,150,-135,-337,-19,1,0,3
3501,02/12/2013,16087,16098,15986,16009,537,207,275,1019,-78,0,0,4
3502,03/12/2013,16005,16005,15860,15915,798,304,149,1251,-90,0,0,4
3503,04/12/2013,15911,15960,15791,15890,-86,288,82,284,-21,0,0,4
3504,05/12/2013,15886,15896,15809,15822,-128,-545,-553,-1226,-64,1,0,3
3505,06/12/2013,15826,16022,15826,16020,322,-894,397,-175,194,0,0,3
3506,09/12/2013,16019,16058,16015,16026,714,464,-199,979,7,0,1,2
3507,10/12/2013,16024,16029,15970,15973,-208,-343,386,-165,-51,1,0,3
3508,11/12/2013,15971,15997,15828,15844,-116,-71,-329,-516,-127,1,0,4
3509,12/12/2013,15845,15845,15704,15739,-205,-596,-585,-1386,-106,1,0,5
3510,13/12/2013,15746,15793,15718,15755,195,-199,41,37,9,0,1,6
3511,16/12/2013,15760,15930,15760,15885,485,963,125,1573,125,0,1,6
3512,17/12/2013,15884,15918,15836,15875,397,-195,282,484,-9,0,0,7
3513,18/12/2013,15877,16173,15809,16168,-80,141,251,312,291,0,1,7
3514,19/12/2013,16163,16195,16122,16179,-480,33,16,-431,16,0,0,8
3515,20/12/2013,16179,16288,16179,16221,95,-3,-82,10,42,0,1,7
3516,23/12/2013,16225,16318,16225,16295,-937,-159,70,-1026,70,0,0,8
3517,24/12/2013,16296,16361,16296,16358,433,395,106,934,62,0,1,7
3518,26/12/2013,16371,16483,16371,16480,182,-47,2,137,109,0,1,7
3519,27/12/2013,16486,16529,16461,16478,80,-32,-8,40,-8,0,0,7
3520,30/12/2013,16485,16504,16477,16504,232,-126,-18,88,19,0,1,6
3521,31/12/2013,16512,16588,16511,16577,-270,68,-40,-242,65,0,0,6
3522,02/01/2014,16572,16573,16416,16441,-242,-131,-131,-504,-131,1,0,5
3523,03/01/2014,16457,16519,16439,16470,199,862,-2,1059,13,0,1,6
3524,06/01/2014,16474,16533,16406,16425,611,-474,-76,61,-49,0,0,6
3525,07/01/2014,16429,16562,16429,16531,-160,73,347,260,102,0,1,6
3526,08/01/2014,16528,16529,16417,16463,281,-120,155,316,-65,0,0,6
3527,09/01/2014,16471,16525,16379,16445,16,-277,355,94,-26,0,0,6
3528,10/01/2014,16454,16488,16379,16437,961,733,54,1748,-17,0,0,5
3529,13/01/2014,16434,16453,16241,16258,-166,-502,72,-596,-176,1,0,4
3530,14/01/2014,16262,16374,16261,16374,297,339,112,748,112,0,1,5
3531,15/01/2014,16378,16505,16377,16482,608,-365,329,572,104,0,1,5
3532,16/01/2014,16478,16478,16376,16417,172,224,40,436,-61,0,0,6
3533,17/01/2014,16408,16495,16379,16459,-88,1167,132,1211,51,0,1,5
3534,21/01/2014,16459,16521,16316,16414,-162,136,-286,-312,-45,1,0,5
3535,22/01/2014,16420,16453,16333,16373,-102,1278,-78,1098,-47,0,0,6
3536,23/01/2014,16372,16373,16141,16197,-202,-15,-327,-544,-175,1,0,5
3537,24/01/2014,16203,16203,15879,15879,-324,-234,-199,-757,-324,1,0,6
3538,27/01/2014,15879,15943,15784,15838,-292,-688,-292,-1272,-41,1,0,7
3539,28/01/2014,15841,15946,15841,15929,248,468,248,964,88,0,1,8
3540,29/01/2014,15927,15927,15709,15739,-514,207,-153,-460,-188,1,0,8
3541,30/01/2014,15743,15908,15733,15849,178,471,178,827,106,0,1,8
3542,31/01/2014,15847,15847,15618,15699,-148,-210,-243,-601,-148,1,0,8
3543,03/02/2014,15698,15709,15356,15373,-325,-310,-325,-960,-325,1,0,9
3544,04/02/2014,15373,15482,15357,15445,72,500,72,644,72,0,1,9
3545,05/02/2014,15443,15478,15341,15440,69,-3,-74,-8,-3,1,0,9
3546,06/02/2014,15444,15632,15443,15629,1176,-590,333,919,185,0,1,10
3547,07/02/2014,15631,15799,15626,15794,303,480,784,1567,163,0,1,10
3548,10/02/2014,15794,15802,15734,15802,-29,219,42,232,8,0,1,10
3549,11/02/2014,15804,16027,15803,15995,111,239,204,554,191,0,1,10
3550,12/02/2014,15993,16037,15929,15964,-29,-321,107,-243,-29,1,0,10
3551,13/02/2014,15947,16039,15863,16028,105,51,-130,26,81,0,1,10
3552,14/02/2014,16018,16176,15985,16154,-30,178,107,255,136,0,1,10
3553,18/02/2014,16154,16167,16107,16130,-24,-46,-28,-98,-24,1,0,10
3554,19/02/2014,16126,16226,16032,16041,378,-91,-85,202,-85,0,0,10
3555,20/02/2014,16044,16162,16007,16133,-387,-119,152,-354,89,0,0,9
3556,21/02/2014,16136,16192,16094,16103,-541,144,-148,-545,-33,1,0,8
3557,24/02/2014,16102,16300,16102,16207,-17,945,71,999,105,0,1,8
3558,25/02/2014,16207,16254,16147,16180,333,140,173,646,-27,0,0,8
3559,26/02/2014,16180,16252,16156,16198,262,-12,-5,245,18,0,1,7
3560,27/02/2014,16198,16276,16160,16273,199,0,-26,173,75,0,1,7
3561,28/02/2014,16273,16399,16226,16322,-722,-158,-110,-990,49,0,0,7
3562,03/03/2014,16322,16322,16071,16168,525,-15,-157,353,-154,0,0,6
3563,04/03/2014,16169,16419,16169,16396,576,179,579,1334,227,0,1,5
3564,05/03/2014,16396,16407,16344,16360,-534,-231,-43,-808,-36,1,0,5
3565,06/03/2014,16361,16450,16361,16422,-33,49,-94,-78,61,0,0,6
3566,07/03/2014,16425,16506,16399,16453,-26,-30,-160,-216,28,0,0,6
3567,10/03/2014,16453,16453,16334,16419,-217,-146,-165,-528,-34,1,0,5
3568,11/03/2014,16419,16460,16325,16351,249,528,-399,378,-68,0,0,5
3569,12/03/2014,16351,16365,16260,16340,80,464,189,733,-11,0,0,5
3570,13/03/2014,16342,16405,16084,16109,-306,19,-239,-526,-233,1,0,4
3571,14/03/2014,16106,16165,16047,16066,90,10,-144,-44,-40,1,0,4
3572,17/03/2014,16066,16270,16066,16247,174,241,181,596,181,0,1,5
3573,18/03/2014,16246,16370,16246,16336,172,370,674,1216,90,0,1,6
3574,19/03/2014,16336,16363,16126,16222,-208,-145,-91,-444,-114,1,0,6
3575,20/03/2014,16222,16354,16160,16331,342,-218,701,825,109,0,1,6
3576,21/03/2014,16333,16456,16291,16303,417,98,151,666,-30,0,0,7
3577,24/03/2014,16303,16381,16216,16277,-560,-118,820,142,-26,0,0,7
3578,25/03/2014,16279,16407,16279,16368,86,-383,-60,-357,89,0,0,6
3579,26/03/2014,16371,16466,16269,16269,177,518,-301,394,-102,0,0,6
3580,27/03/2014,16269,16301,16192,16264,210,-52,-125,33,-5,0,0,6
3581,28/03/2014,16268,16415,16268,16323,146,2,173,321,55,0,1,5
3582,31/03/2014,16324,16481,16324,16458,209,-699,727,237,134,0,1,5
3583,01/04/2014,16458,16566,16458,16533,-485,-119,-330,-934,75,0,0,5
3584,02/04/2014,16533,16588,16507,16573,-852,-205,-139,-1196,40,0,0,4
3585,03/04/2014,16572,16604,16528,16573,-570,67,-91,-594,1,0,0,3
3586,04/04/2014,16576,16632,16393,16413,-526,-503,-159,-1188,-163,1,0,2
3587,07/04/2014,16414,16421,16244,16246,109,204,-405,-92,-168,1,0,3
3588,08/04/2014,16245,16297,16180,16256,-26,11,79,64,11,0,1,4
3589,09/04/2014,16256,16439,16256,16437,-14,229,158,373,181,0,1,5
3590,10/04/2014,16437,16456,16153,16170,-558,-533,69,-1022,-267,1,0,6
3591,11/04/2014,16169,16169,16015,16027,10,-142,-142,-274,-142,1,0,7
3592,14/04/2014,16028,16185,16028,16173,145,152,145,442,145,0,1,7
3593,15/04/2014,16173,16273,16063,16263,13,374,90,477,90,0,1,7
3594,16/04/2014,16266,16425,16266,16425,254,-523,183,-86,159,0,0,8
3595,17/04/2014,16424,16460,16368,16409,-52,49,-183,-186,-15,1,0,8
3596,21/04/2014,16409,16460,16402,16449,18,-37,-183,-202,40,0,0,9
3597,22/04/2014,16449,16566,16449,16514,-83,445,-78,284,65,0,1,8
3598,23/04/2014,16514,16526,16477,16502,-113,-204,-299,-616,-12,1,0,8
3599,24/04/2014,16503,16541,16452,16502,-1,-767,-78,-846,-1,1,0,8
3600,25/04/2014,16503,16503,16334,16361,173,-219,-78,-124,-142,1,0,8
3601,28/04/2014,16363,16500,16313,16449,233,61,97,391,86,0,1,8
3602,29/04/2014,16451,16559,16451,16535,-52,-301,188,-165,84,0,0,8
3603,30/04/2014,16535,16592,16511,16581,52,255,229,536,46,0,1,7
3604,01/05/2014,16580,16605,16525,16559,-111,46,-274,-339,-21,1,0,7
3605,02/05/2014,16562,16620,16488,16513,47,1145,-2,1190,-49,0,0,8
3606,05/05/2014,16510,16548,16377,16531,81,-121,101,61,21,0,1,7
3607,06/05/2014,16530,16530,16400,16401,93,-372,-91,-370,-129,1,0,8
3608,07/05/2014,16402,16523,16357,16519,490,227,214,931,117,0,1,8
3609,08/05/2014,16518,16623,16502,16551,-142,157,-91,-76,33,0,0,8
3610,09/05/2014,16551,16589,16499,16583,34,164,157,355,32,0,1,7
3611,12/05/2014,16584,16584,16704,16695,554,521,180,1255,111,0,1,7
3612,13/05/2014,16695,16695,16735,16715,525,58,-152,431,20,0,1,7
3613,14/05/2014,16716,16717,16595,16613,275,21,-136,160,-103,0,0,8
3614,15/05/2014,16613,16622,16397,16446,296,-252,-539,-495,-167,1,0,7
3615,16/05/2014,16447,16498,16414,16491,136,-164,173,145,44,0,1,7
3616,19/05/2014,16490,16526,16442,16512,-202,168,370,336,22,0,1,8
3617,20/05/2014,16511,16511,16341,16374,14,-22,103,95,-137,0,0,8
3618,21/05/2014,16376,16544,16376,16533,322,164,68,554,157,0,1,7
3619,22/05/2014,16532,16565,16489,16543,171,269,455,895,11,0,1,7
3620,23/05/2014,16544,16613,16544,16606,87,-110,313,290,62,0,1,8
3621,27/05/2014,16607,16688,16607,16675,275,-141,305,439,68,0,1,8
3622,28/05/2014,16674,16674,16620,16633,-52,9,102,59,-41,0,0,8
3623,29/05/2014,16637,16698,16620,16698,175,74,10,259,61,0,1,7
3624,30/05/2014,16697,16721,16648,16717,129,538,-62,605,20,0,1,8
3625,02/06/2014,16716,16756,16682,16743,-311,299,315,303,27,0,1,8
3626,03/06/2014,16736,16736,16690,16722,-212,56,-224,-380,-14,1,0,8
3627,04/06/2014,16720,16742,16673,16737,369,14,-67,316,17,0,1,8
3628,05/06/2014,16739,16845,16709,16836,332,-293,174,213,97,0,1,9
3629,06/06/2014,16839,16924,16839,16924,3,-146,-66,-209,85,0,0,9
