,Date,Open,High,Low,Close,a1,a2,a3,a4,pl,,,
2000,29/11/2007,6306,6364,6273,6349,139,-205,-31,-97,43,0,,
2001,30/11/2007,6349,6456,6334,6432,110,131,83,324,83,0,1,
2002,03/12/2007,6432,6456,6380,6387,33,59,-45,47,-45,0,0,
2003,04/12/2007,6387,6398,6289,6315,-90,110,-10,10,-72,0,0,
2004,05/12/2007,6315,6494,6315,6494,199,342,359,900,179,0,1,
2005,06/12/2007,6494,6592,6438,6486,212,-51,-8,153,-8,0,0,
2006,07/12/2007,6486,6578,6486,6555,74,69,8,151,69,0,1,
2007,10/12/2007,6555,6597,6524,6565,184,64,64,312,10,0,1,
2008,11/12/2007,6565,6598,6513,6537,-189,-4,-47,-240,-28,1,0,
2009,12/12/2007,6537,6611,6430,6560,-155,230,-63,12,23,0,1,
2010,13/12/2007,6560,6560,6364,6364,-223,-507,-63,-793,-196,1,0,
2011,14/12/2007,6364,6426,6337,6397,182,110,-91,201,33,0,1,
2012,17/12/2007,6397,6397,6264,6278,177,-122,-123,-68,-119,1,0,7
2013,18/12/2007,6278,6344,6254,6279,15,1,84,100,1,0,1,8
2014,19/12/2007,6279,6319,6252,6284,5,60,95,160,5,0,1,9
2015,20/12/2007,6284,6368,6284,6346,-52,54,62,64,62,0,1,9
2016,21/12/2007,6346,6452,6346,6434,-15,-122,267,130,88,0,1,10
2017,24/12/2007,6434,6486,6431,6479,343,-15,247,575,45,0,1,10
2018,27/12/2007,6479,6505,6468,6498,179,-185,134,128,19,0,1,10
2019,28/12/2007,6498,6498,6437,6477,124,-321,-72,-269,-21,1,0,10
2020,31/12/2007,6477,6480,6433,6457,-16,-18,-4,-38,-20,1,0,10
2021,02/01/2008,6457,6512,6403,6417,-209,-217,-44,-470,-40,1,0,10
2022,03/01/2008,6417,6488,6395,6479,269,-13,-42,214,62,0,1,10
2023,04/01/2008,6479,6535,6333,6348,132,-404,-44,-316,-131,1,0,10
2024,07/01/2008,6348,6376,6275,6336,-10,105,-177,-82,-12,1,0,10
2025,08/01/2008,6336,6400,6336,6356,-12,34,-44,-22,20,0,0,10
2026,09/01/2008,6356,6356,6242,6273,-12,72,-177,-117,-83,1,0,9
2027,10/01/2008,6273,6314,6213,6223,-38,161,3,126,-50,0,0,9
2028,11/01/2008,6223,6252,6147,6202,624,-396,228,456,-21,0,0,8
2029,14/01/2008,6202,6247,6173,6216,132,-123,367,376,14,0,1,7
2030,15/01/2008,6216,6216,6026,6026,-177,-94,-211,-482,-190,1,0,7
2031,16/01/2008,6026,6032,5908,5943,-83,270,-83,104,-83,0,0,7
2032,17/01/2008,5943,6028,5895,5902,-41,-198,-41,-280,-41,1,0,6
2033,18/01/2008,5902,6031,5857,5902,192,473,192,857,0,0,0,6
2034,21/01/2008,5902,5902,5571,5578,-507,-450,-507,-1464,-324,1,0,5
2035,22/01/2008,5578,5764,5339,5740,162,364,162,688,162,0,1,5
2036,23/01/2008,5740,5845,5518,5609,-47,-20,-101,-168,-131,1,0,6
2037,24/01/2008,5609,5882,5609,5876,267,267,401,935,267,0,1,6
2038,25/01/2008,5876,5973,5848,5869,-187,-195,-137,-519,-7,1,0,7
2039,28/01/2008,5869,5869,5705,5789,73,-178,-438,-543,-80,1,0,8
2040,29/01/2008,5789,5885,5789,5885,339,-165,358,532,96,0,1,8
2041,30/01/2008,5885,5885,5819,5837,-24,13,169,158,-48,0,0,8
2042,31/01/2008,5837,5900,5689,5880,170,308,-33,445,43,0,1,8
2043,01/02/2008,5880,6045,5880,6029,139,448,317,904,149,0,1,8
2044,04/02/2008,6029,6071,6000,6026,-3,10,-3,4,-3,0,0,9
2045,05/02/2008,6026,6026,5853,5868,-159,-149,-181,-489,-158,1,0,8
2046,06/02/2008,5868,5893,5816,5875,99,157,-133,123,7,0,1,8
2047,07/02/2008,5875,5875,5709,5724,-189,-35,89,-135,-151,1,0,8
2048,08/02/2008,5724,5805,5703,5784,886,86,75,1047,60,0,1,8
2049,11/02/2008,5784,5790,5682,5708,4,-91,-94,-181,-76,1,0,8
2050,12/02/2008,5708,5910,5708,5910,886,288,214,1388,202,0,1,8
2051,13/02/2008,5910,5915,5815,5880,-143,-223,-254,-620,-30,1,0,8
2052,14/02/2008,5880,5938,5859,5879,-185,-60,52,-193,-1,1,0,9
2053,15/02/2008,5879,5915,5764,5788,-180,-98,138,-140,-91,1,0,9
2054,19/02/2008,5947,6034,5885,5967,47,19,103,169,20,0,1,9
2055,20/02/2008,5967,5967,5847,5894,-228,-264,-42,-534,-73,1,0,10
2056,21/02/2008,5894,6004,5894,5932,146,-193,65,18,38,0,1,10
2057,22/02/2008,5932,5971,5864,5888,-209,-441,-162,-812,-44,1,0,10
2058,25/02/2008,5888,6012,5888,6000,137,335,313,785,112,0,1,10
2059,26/02/2008,6000,6092,5992,6087,139,-46,10,103,87,0,1,10
2060,27/02/2008,6087,6104,5989,6076,-314,-154,55,-413,-11,1,0,10
2061,28/02/2008,6076,6091,5960,5966,160,-75,-165,-80,-110,1,0,10
2062,29/02/2008,5966,5986,5859,5884,-241,-185,145,-281,-82,1,0,10
2063,03/03/2008,5884,5884,5770,5819,120,-112,-314,-306,-65,1,0,10
2064,04/03/2008,5819,5873,5720,5768,-200,-6,-51,-257,-51,1,0,10
2065,05/03/2008,5768,5860,5764,5854,86,288,123,497,86,0,1,10
2066,06/03/2008,5854,5871,5753,5766,-158,-308,-185,-651,-88,1,0,10
2067,07/03/2008,5766,5766,5656,5700,-52,-48,-14,-114,-66,1,0,10
2068,10/03/2008,5700,5719,5617,5629,-71,-414,-71,-556,-71,1,0,10
2069,11/03/2008,5629,5783,5629,5690,23,17,23,63,61,0,1,10
2070,12/03/2008,5690,5813,5690,5776,121,0,261,382,86,0,1,10
2071,13/03/2008,5776,5776,5629,5692,231,117,-229,119,-84,0,0,10
2072,14/03/2008,5692,5782,5596,5632,10,-361,2,-349,-60,1,0,9
2073,17/03/2008,5632,5632,5414,5414,-109,-248,238,-119,-218,1,0,9
2074,18/03/2008,5414,5610,5414,5606,192,462,192,846,192,0,1,9
2075,19/03/2008,5606,5654,5525,5546,233,169,163,565,-60,0,0,9
2076,20/03/2008,5546,5546,5462,5495,119,-195,141,65,-51,0,0,8
2077,25/03/2008,5495,5704,5495,5689,156,250,204,610,194,0,1,7
2078,26/03/2008,5689,5689,5639,5660,-148,331,-32,151,-29,0,0,7
2079,27/03/2008,5660,5735,5651,5718,-87,478,260,651,58,0,1,6
2080,28/03/2008,5718,5747,5674,5693,139,-209,113,43,-25,0,0,6
2081,31/03/2008,5693,5715,5586,5702,-45,5,134,94,9,0,1,5
2082,01/04/2008,5702,5866,5670,5853,105,348,339,792,151,0,1,6
2083,02/04/2008,5853,5920,5827,5916,33,10,56,99,63,0,1,6
2084,03/04/2008,5916,5935,5864,5891,-6,-25,-25,-56,-25,1,0,6
2085,04/04/2008,5891,5948,5888,5947,11,33,128,172,56,0,1,6
2086,07/04/2008,5947,6015,5947,6015,184,64,64,312,68,0,1,7
2087,08/04/2008,6015,6015,5942,5990,-211,-13,-13,-237,-25,1,0,8
2088,09/04/2008,5990,6016,5947,5984,66,-178,-25,-137,-6,1,0,8
2089,10/04/2008,5984,6003,5882,5965,-80,-44,8,-116,-19,1,0,9
2090,11/04/2008,5965,6016,5866,5896,-310,146,61,-103,-69,1,0,9
2091,14/04/2008,5896,5896,5827,5832,-218,1,139,-78,-64,1,0,10
2092,15/04/2008,5832,5943,5832,5907,123,95,148,366,75,0,1,10
2093,16/04/2008,5907,6046,5907,6046,98,448,165,711,139,0,1,10
2094,17/04/2008,6046,6086,5974,5980,71,-464,-87,-480,-66,1,0,10
2095,18/04/2008,5980,6062,5974,6056,-69,-101,95,-75,76,0,0,10
2096,21/04/2008,6056,6090,6021,6053,188,-38,-80,70,-3,0,0,9
2097,22/04/2008,6053,6072,6008,6035,-466,-576,-168,-1210,-18,1,0,8
2098,23/04/2008,6035,6084,5979,6084,444,-121,-134,189,49,0,1,8
2099,24/04/2008,6084,6084,5952,6051,71,-464,-87,-480,-33,1,0,8
2100,25/04/2008,6051,6099,6046,6091,-45,-165,150,-60,40,0,0,8
2101,28/04/2008,6091,6134,6084,6090,-259,-344,-157,-760,-1,1,0,7
2102,29/04/2008,6090,6134,6052,6089,189,-286,-527,-624,-1,1,0,7
2103,30/04/2008,6089,6120,6036,6087,352,-214,247,385,-2,0,0,7
2104,01/05/2008,6087,6118,6066,6087,14,-44,239,209,0,0,0,6
2105,02/05/2008,6087,6224,6087,6216,-36,165,46,175,129,0,1,5
2106,06/05/2008,6216,6234,6156,6215,-320,55,149,-116,-1,1,0,6
2107,07/05/2008,6215,6275,6214,6261,-224,-44,-10,-278,46,0,0,7
2108,08/05/2008,6256,6273,6217,6271,-410,17,54,-339,15,0,0,6
2109,09/05/2008,6271,6271,6168,6205,-249,50,50,-149,-66,1,0,5
2110,12/05/2008,6205,6252,6185,6221,407,233,281,921,16,0,1,5
2111,13/05/2008,6221,6268,6142,6212,60,30,134,224,-9,0,0,6
2112,14/05/2008,6212,6253,6168,6216,-6,218,14,226,4,0,1,5
2113,15/05/2008,6216,6258,6169,6252,19,149,261,429,36,0,1,5
2114,16/05/2008,6252,6349,6252,6304,92,258,-45,305,52,0,1,6
2115,19/05/2008,6304,6377,6303,6376,-123,-342,-278,-743,72,0,0,7
2116,20/05/2008,6376,6376,6192,6192,-280,-405,-332,-1017,-184,1,0,6
2117,21/05/2008,6192,6257,6184,6198,58,19,57,134,6,0,1,6
2118,22/05/2008,6198,6226,6159,6182,39,324,31,394,-16,0,0,7
2119,23/05/2008,6182,6183,6087,6087,158,108,-52,214,-95,0,0,7
2120,27/05/2008,6087,6142,6049,6058,-200,53,-36,-183,-29,1,0,6
2121,28/05/2008,6058,6122,6052,6070,12,359,246,617,12,0,1,6
2122,29/05/2008,6070,6130,6041,6068,78,-116,97,59,-2,0,0,7
2123,30/05/2008,6068,6112,6045,6054,-14,-148,-62,-224,-14,1,0,6
2124,02/06/2008,6054,6061,5978,6008,-87,64,-29,-52,-46,1,0,6
2125,03/06/2008,6008,6059,5993,6058,149,99,37,285,50,0,1,6
2126,04/06/2008,6058,6058,5933,5970,-338,-283,-110,-731,-88,1,0,7
2127,05/06/2008,5970,6005,5941,5995,-5,64,-107,-48,25,0,0,7
2128,06/06/2008,5995,6074,5906,5907,-113,164,-97,-46,-88,1,0,6
2129,09/06/2008,5907,5938,5870,5878,45,99,65,209,-29,0,0,7
2130,10/06/2008,5878,5878,5813,5827,-41,-287,94,-234,-51,1,0,7
2131,11/06/2008,5827,5859,5708,5723,-127,-129,-275,-531,-104,1,0,7
2132,12/06/2008,5723,5798,5720,5790,140,17,140,297,67,0,1,7
2133,13/06/2008,5790,5818,5720,5803,47,47,102,196,13,0,1,8
2134,16/06/2008,5803,5833,5760,5795,121,54,121,296,-8,0,0,8
2135,17/06/2008,5795,5930,5795,5862,136,5,393,534,67,0,1,7
2136,18/06/2008,5862,5862,5735,5757,-172,-123,-438,-733,-105,1,0,7
2137,19/06/2008,5757,5786,5707,5708,208,-18,-19,171,-49,0,0,7
2138,20/06/2008,5708,5732,5597,5621,-264,-139,-117,-520,-87,1,0,7
2139,23/06/2008,5621,5679,5603,5667,774,-123,246,897,46,0,1,7
2140,24/06/2008,5667,5694,5582,5635,325,-171,207,361,-32,0,0,8
2141,25/06/2008,5635,5670,5635,5666,403,-44,31,390,31,0,1,7
2142,26/06/2008,5666,5666,5518,5518,255,-263,-20,-28,-148,1,0,7
2143,27/06/2008,5518,5555,5471,5530,395,-161,20,254,12,0,1,7
2144,30/06/2008,5530,5626,5520,5626,-186,215,37,66,96,0,1,7
2145,01/07/2008,5626,5626,5466,5480,-146,-365,-56,-567,-146,1,0,8
2146,02/07/2008,5480,5567,5426,5426,240,92,58,390,-54,0,0,8
2147,03/07/2008,5426,5491,5358,5477,-28,-358,258,-128,51,0,0,7
2148,04/07/2008,5477,5490,5394,5413,325,-171,207,361,-64,0,0,7
2149,07/07/2008,5413,5516,5400,5513,-147,-221,90,-278,100,0,0,6
2150,08/07/2008,5513,5513,5359,5440,-122,304,-42,140,-73,0,0,5
2151,09/07/2008,5440,5538,5440,5530,150,339,-86,403,90,0,1,5
2152,10/07/2008,5530,5530,5393,5407,-267,-27,146,-148,-123,1,0,5
2153,11/07/2008,5407,5462,5262,5262,-105,338,-145,88,-145,0,0,5
2154,14/07/2008,5262,5373,5262,5300,55,-45,-55,-45,38,0,0,4
2155,15/07/2008,5300,5300,5119,5172,-159,0,-263,-422,-128,1,0,3
2156,16/07/2008,5172,5210,5071,5151,365,416,365,1146,-21,0,0,3
2157,17/07/2008,5151,5320,5151,5286,328,533,328,1189,135,0,1,3
2158,18/07/2008,5286,5376,5217,5376,165,93,175,433,90,0,1,4
2159,21/07/2008,5376,5446,5335,5404,140,7,90,237,28,0,1,5
2160,22/07/2008,5404,5404,5283,5364,-34,34,-17,-17,-40,1,0,6
2161,23/07/2008,5364,5467,5364,5450,76,201,156,433,86,0,1,7
2162,24/07/2008,5450,5464,5345,5362,402,-100,-102,200,-88,0,0,7
2163,25/07/2008,5362,5375,5291,5353,-28,301,60,333,-9,0,0,6
2164,28/07/2008,5353,5366,5308,5313,140,38,-70,108,-40,0,0,6
2165,29/07/2008,5313,5355,5261,5319,49,-17,-40,-8,6,0,0,6
2166,30/07/2008,5319,5436,5319,5421,-184,236,-38,14,102,0,1,5
2167,31/07/2008,5421,5456,5371,5412,137,-191,-180,-234,-9,1,0,6
2168,01/08/2008,5412,5412,5321,5355,-267,-222,-78,-567,-57,1,0,6
2169,04/08/2008,5355,5415,5310,5320,272,81,-50,303,-35,0,0,6
2170,05/08/2008,5320,5454,5300,5454,46,163,39,248,134,0,1,5
2171,06/08/2008,5454,5499,5440,5486,-183,-190,104,-269,32,0,0,5
2172,07/08/2008,5486,5539,5451,5478,184,0,-8,176,-8,0,0,4
2173,08/08/2008,5478,5507,5411,5489,-469,25,-591,-1035,11,0,0,4
2174,11/08/2008,5489,5542,5478,5542,-4,417,169,582,53,0,1,4
2175,12/08/2008,5542,5569,5491,5534,-316,-572,-602,-1490,-8,1,0,5
2176,13/08/2008,5534,5534,5437,5449,-443,-246,-268,-957,-85,1,0,6
2177,14/08/2008,5449,5540,5446,5497,419,-256,3,166,48,0,1,6
2178,15/08/2008,5497,5539,5432,5455,-187,-189,97,-279,-42,1,0,6
2179,18/08/2008,5455,5499,5425,5450,-68,60,67,59,-5,0,0,6
2180,19/08/2008,5450,5450,5317,5320,199,-10,-160,29,-130,0,0,6
2181,20/08/2008,5320,5384,5320,5372,66,52,-14,104,52,0,1,5
2182,21/08/2008,5372,5408,5311,5370,-14,118,166,270,-2,0,0,6
2183,22/08/2008,5370,5506,5368,5506,88,-77,42,53,136,0,1,6
2184,26/08/2008,5506,5506,5369,5471,-84,-185,79,-190,-35,1,0,7
2185,27/08/2008,5471,5541,5435,5528,400,-11,387,776,57,0,1,7
2186,28/08/2008,5528,5634,5497,5601,-28,-433,95,-366,73,0,0,7
2187,29/08/2008,5601,5649,5587,5637,-111,146,48,83,36,0,1,6
2188,01/09/2008,5637,5637,5574,5603,-325,-43,-43,-411,-34,1,0,6
2189,02/09/2008,5603,5646,5575,5621,-135,230,111,206,18,0,1,6
2190,03/09/2008,5621,5621,5492,5500,21,-55,111,77,-121,0,0,7
2191,04/09/2008,5500,5542,5362,5362,-389,-195,-162,-746,-138,1,0,7
2192,05/09/2008,5362,5362,5228,5241,-247,-121,-121,-489,-121,1,0,7
2193,08/09/2008,5241,5448,5241,5446,203,151,205,559,205,0,1,8
2194,09/09/2008,5446,5525,5387,5416,-148,-89,-51,-288,-30,1,0,8
2195,10/09/2008,5416,5420,5328,5366,109,180,-158,131,-50,0,0,8
2196,11/09/2008,5366,5378,5258,5318,-117,-502,-62,-681,-48,1,0,7
2197,12/09/2008,5318,5417,5318,5417,156,272,83,511,99,0,1,8
2198,15/09/2008,5417,5417,5125,5204,-43,-259,-92,-394,-213,1,0,8
2199,16/09/2008,5204,5204,4961,5026,-256,-161,-256,-673,-178,1,0,8
2200,17/09/2008,5026,5124,4903,4912,-208,-56,-114,-378,-114,1,0,8
2201,18/09/2008,4912,5016,4861,4880,111,190,111,412,-32,0,0,9
2202,19/09/2008,4880,5351,4857,5311,431,742,431,1604,431,0,1,8
2203,22/09/2008,5311,5339,5236,5236,11,-75,-165,-229,-75,1,0,8
2204,23/09/2008,5236,5236,5076,5136,-220,-272,-225,-717,-100,1,0,8
2205,24/09/2008,5136,5167,5087,5096,258,283,50,591,-40,0,0,8
2206,25/09/2008,5096,5212,5061,5197,-145,-128,346,73,101,0,1,8
2207,26/09/2008,5197,5197,5057,5088,-617,163,-178,-632,-109,1,0,8
2208,29/09/2008,5088,5088,4819,4819,-9,-447,-215,-671,-269,1,0,8
2209,30/09/2008,4819,4953,4671,4902,-315,-97,-315,-727,83,0,0,8
2210,01/10/2008,4902,5012,4892,4960,774,-114,336,996,58,0,1,7
2211,02/10/2008,4960,5052,4862,4870,-254,-58,-3,-315,-90,1,0,7
2212,03/10/2008,4870,5004,4832,4980,48,110,179,337,110,0,1,8
2213,06/10/2008,4980,4980,4550,4589,-138,-557,-232,-927,-391,1,0,8
2214,07/10/2008,4589,4745,4518,4605,16,682,16,714,16,0,1,8
2215,08/10/2008,4605,4654,4245,4367,-238,-238,-238,-714,-238,1,0,8
2216,09/10/2008,4367,4512,4274,4314,-53,-29,-53,-135,-53,1,0,9
2217,10/10/2008,4314,4314,3874,3932,-382,-382,-382,-1146,-382,1,0,9
2218,13/10/2008,3932,4257,3932,4257,325,325,325,975,325,0,1,9
2219,14/10/2008,4257,4534,4257,4394,271,306,137,714,137,0,1,9
2220,15/10/2008,4394,4394,4052,4080,-147,-113,-101,-361,-314,1,0,10
2221,16/10/2008,4080,4080,3808,3861,-219,-219,-219,-657,-219,1,0,10
2222,17/10/2008,3861,4078,3861,4063,202,311,202,715,202,0,1,10
2223,20/10/2008,4063,4283,4063,4283,370,472,245,1087,220,0,1,10
2224,21/10/2008,4283,4348,4212,4230,-216,55,-63,-224,-53,1,0,10
2225,22/10/2008,4230,4230,4032,4041,-154,-276,-589,-1019,-189,1,0,10
2226,23/10/2008,4041,4108,3928,4088,103,-291,145,-43,47,0,0,10
2227,24/10/2008,4088,4088,3715,3883,417,-237,-170,10,-205,0,0,9
2228,27/10/2008,3883,3912,3665,3853,-86,-30,-30,-146,-30,1,0,8
2229,28/10/2008,3853,4034,3848,3926,140,231,141,512,73,0,1,8
2230,29/10/2008,3926,4242,3926,4242,156,296,39,491,316,0,1,8
2231,30/10/2008,4242,4352,4200,4292,-374,50,160,-164,50,0,0,8
2232,31/10/2008,4292,4384,4195,4377,110,110,160,380,85,0,1,7
2233,03/11/2008,4377,4443,4348,4443,86,66,66,218,66,0,1,7
2234,04/11/2008,4443,4640,4404,4640,197,197,197,591,197,0,1,7
2235,05/11/2008,4640,4640,4496,4531,-109,-109,-109,-327,-109,1,0,7
2236,06/11/2008,4531,4531,4260,4272,-259,-259,-259,-777,-259,1,0,7
2237,07/11/2008,4272,4408,4264,4365,150,237,-12,375,93,0,1,8
2238,10/11/2008,4365,4525,4365,4404,-310,-275,-180,-765,39,0,0,9
2239,11/11/2008,4404,4404,4232,4247,-208,-191,-343,-742,-157,1,0,8
2240,12/11/2008,4247,4333,4134,4182,-87,-65,-65,-217,-65,1,0,8
2241,13/11/2008,4182,4199,4080,4169,-13,-13,127,101,-13,0,0,8
2242,14/11/2008,4169,4342,4169,4233,8,64,127,199,64,0,1,8
2243,17/11/2008,4233,4236,4111,4132,-1,-175,-9,-185,-101,1,0,8
2244,18/11/2008,4132,4208,4033,4208,222,76,127,425,76,0,1,8
2245,19/11/2008,4208,4213,3999,4006,-419,-265,0,-684,-202,1,0,8
2246,20/11/2008,4006,4006,3812,3875,-98,-131,-131,-360,-131,1,0,8
2247,21/11/2008,3875,3947,3734,3781,-208,-94,-94,-396,-94,1,0,8
2248,24/11/2008,3781,4153,3781,4153,372,742,372,1486,372,0,1,8
2249,25/11/2008,4153,4268,4069,4171,174,82,-114,142,18,0,1,9
2250,26/11/2008,4171,4199,4051,4153,11,123,134,268,-18,0,0,9
2251,27/11/2008,4153,4242,4153,4226,-1,-122,190,67,73,0,1,8
2252,28/11/2008,4226,4288,4192,4288,228,145,142,515,62,0,1,9
2253,01/12/2008,4288,4288,4038,4066,-374,-451,-424,-1249,-222,1,0,9
2254,02/12/2008,4066,4137,3973,4123,-381,-241,336,-286,57,0,0,9
2255,03/12/2008,4123,4191,4042,4170,647,308,160,1115,47,0,1,8
2256,04/12/2008,4170,4261,4090,4164,-222,-191,-67,-480,-6,1,0,8
2257,05/12/2008,4164,4164,4002,4049,-195,-54,-78,-327,-115,1,0,8
2258,08/12/2008,4049,4318,4049,4300,35,251,-86,200,251,0,1,8
2259,09/12/2008,4300,4413,4233,4381,301,-96,42,247,81,0,1,8
2260,10/12/2008,4381,4407,4330,4367,111,64,64,239,-14,0,0,8
2261,11/12/2008,4367,4430,4308,4389,66,-4,22,84,22,0,1,8
2262,12/12/2008,4389,4389,4202,4280,-14,-177,-168,-359,-109,1,0,8
2263,15/12/2008,4280,4341,4239,4278,189,-90,-61,38,-2,0,0,8
2264,16/12/2008,4278,4330,4246,4309,355,130,-88,397,31,0,1,7
2265,17/12/2008,4309,4341,4231,4324,-170,321,8,159,15,0,1,8
2266,18/12/2008,4324,4353,4283,4331,2,139,8,149,7,0,1,8
2267,19/12/2008,4331,4331,4201,4287,25,118,0,143,-44,0,0,8
2268,22/12/2008,4287,4305,4220,4249,62,531,-29,564,-38,0,0,7
2269,23/12/2008,4249,4307,4244,4256,-56,105,79,128,7,0,1,6
2270,24/12/2008,4256,4256,4205,4217,68,235,-39,264,-39,0,0,6
2271,29/12/2008,4217,4326,4217,4319,222,198,92,512,102,0,1,6
2272,30/12/2008,4319,4406,4319,4393,239,458,52,749,74,0,1,6
2273,31/12/2008,4393,4456,4393,4434,44,-466,-242,-664,41,0,0,6
2274,02/01/2009,4434,4562,4430,4562,-202,112,112,22,128,0,1,6
2275,05/01/2009,4562,4618,4521,4580,41,6,6,53,18,0,1,6
2276,06/01/2009,4580,4676,4562,4639,-18,59,59,100,59,0,1,6
2277,07/01/2009,4639,4639,4478,4508,-37,-131,-131,-299,-131,1,0,6
2278,08/01/2009,4508,4515,4410,4505,22,-578,114,-442,-3,1,0,7
2279,09/01/2009,4505,4535,4432,4448,391,-217,-352,-178,-57,1,0,8
2280,12/01/2009,4448,4471,4402,4426,-147,403,-244,12,-22,0,0,8
2281,13/01/2009,4426,4426,4321,4399,224,-6,109,327,-27,0,0,8
2282,14/01/2009,4399,4426,4115,4181,19,-194,-228,-403,-218,1,0,7
2283,15/01/2009,4181,4199,4091,4121,-60,261,-60,141,-60,0,0,7
2284,16/01/2009,4121,4252,4121,4147,26,329,26,381,26,0,1,7
2285,19/01/2009,4147,4252,4032,4108,-39,72,-39,-6,-39,1,0,7
2286,20/01/2009,4108,4184,4061,4091,-55,-999,-55,-1109,-17,1,0,7
2287,21/01/2009,4091,4113,4001,4060,-31,-12,-31,-74,-31,1,0,7
2288,22/01/2009,4060,4154,4046,4052,-256,-489,-256,-1001,-8,1,0,7
2289,23/01/2009,4052,4071,3957,4052,-14,68,-81,-27,0,0,0,7
2290,26/01/2009,4052,4225,4039,4209,36,75,-59,52,157,0,1,6
2291,27/01/2009,4209,4211,4131,4194,-82,-15,190,93,-15,0,0,7
2292,28/01/2009,4194,4318,4194,4295,-89,-9,187,89,101,0,1,7
2293,29/01/2009,4295,4295,4148,4190,-105,-241,-105,-451,-105,1,0,7
2294,30/01/2009,4190,4228,4125,4150,-80,-234,61,-253,-40,1,0,8
2295,02/02/2009,4150,4150,4037,4078,-109,-27,-47,-183,-72,1,0,8
2296,03/02/2009,4078,4173,4043,4164,158,42,-79,121,86,0,1,8
2297,04/02/2009,4164,4263,4160,4229,-254,62,33,-159,65,0,0,8
2298,05/02/2009,4229,4235,4134,4229,-264,-186,-67,-517,0,0,0,7
2299,06/02/2009,4229,4331,4226,4292,647,398,339,1384,63,0,1,6
2300,09/02/2009,4292,4334,4244,4308,1,192,25,218,16,0,1,7
2301,10/02/2009,4308,4310,4210,4213,139,-237,-320,-418,-95,1,0,7
2302,11/02/2009,4213,4244,4182,4234,45,54,65,164,21,0,1,8
2303,12/02/2009,4234,4234,4135,4202,163,94,-148,109,-32,0,0,8
2304,13/02/2009,4202,4292,4168,4190,-77,252,-220,-45,-12,1,0,7
2305,16/02/2009,4190,4190,4127,4135,-119,-139,77,-181,-55,1,0,7
2306,17/02/2009,4135,4135,3995,4034,-95,-205,-43,-343,-101,1,0,7
2307,18/02/2009,4034,4056,3938,4007,5,-216,-27,-238,-27,1,0,7
2308,19/02/2009,4007,4045,3984,4018,120,-521,5,-396,11,0,0,8
2309,20/02/2009,4018,4018,3878,3889,-70,224,-45,109,-129,0,0,8
2310,23/02/2009,3889,3960,3845,3851,6,-370,6,-358,-38,1,0,7
2311,24/02/2009,3851,3852,3772,3816,-35,17,-35,-53,-35,1,0,7
2312,25/02/2009,3816,3884,3804,3849,-98,416,33,351,33,0,1,7
2313,26/02/2009,3849,3948,3849,3916,128,26,116,270,67,0,1,7
2314,27/02/2009,3916,3916,3761,3830,-13,-42,-187,-242,-86,1,0,8
2315,02/03/2009,3830,3830,3626,3626,-289,-502,-50,-841,-204,1,0,8
2316,03/03/2009,3626,3677,3497,3512,-114,265,-114,37,-114,0,0,8
2317,04/03/2009,3512,3650,3512,3646,271,329,401,1001,134,0,1,7
2318,05/03/2009,3646,3646,3526,3530,-54,4,-222,-272,-116,1,0,7
2319,06/03/2009,3530,3590,3492,3531,-72,1,74,3,1,0,1,8
2320,09/03/2009,3531,3565,3461,3542,-24,11,-112,-125,11,0,0,9
2321,10/03/2009,3542,3726,3516,3715,276,272,186,734,173,0,1,8
2322,11/03/2009,3715,3763,3652,3694,-159,350,292,483,-21,0,0,8
2323,12/03/2009,3694,3726,3616,3712,647,83,260,990,18,0,1,7
2324,13/03/2009,3712,3816,3712,3754,65,-10,114,169,42,0,1,7
2325,16/03/2009,3754,3864,3754,3864,437,148,302,887,110,0,1,7
2326,17/03/2009,3864,3864,3793,3857,33,10,56,99,-7,0,0,7
2327,18/03/2009,3857,3902,3768,3805,148,-149,-52,-53,-52,1,0,7
2328,19/03/2009,3805,3913,3794,3817,22,-1,-79,-58,12,0,0,7
2329,20/03/2009,3817,3855,3778,3843,46,-32,202,216,26,0,1,6
2330,23/03/2009,3843,3979,3843,3953,40,241,110,391,110,0,1,6
2331,24/03/2009,3953,3992,3878,3912,187,-178,-169,-160,-41,1,0,7
2332,25/03/2009,3912,3939,3853,3900,-20,-441,-38,-499,-12,1,0,7
2333,26/03/2009,3900,3930,3878,3925,438,115,-52,501,25,0,1,8
2334,27/03/2009,3925,3950,3878,3899,-397,-10,-100,-507,-26,1,0,8
2335,30/03/2009,3899,3899,3763,3763,74,-173,-210,-309,-136,1,0,8
2336,31/03/2009,3763,3931,3763,3926,221,316,300,837,163,0,1,8
2337,01/04/2009,3926,3973,3838,3956,57,-405,-70,-418,30,0,0,9
2338,02/04/2009,3956,4138,3956,4125,-123,-117,102,-138,169,0,0,8
2339,03/04/2009,4125,4133,4016,4030,-176,-95,-95,-366,-95,1,0,8
2340,06/04/2009,4030,4097,3960,3994,-20,-655,96,-579,-36,1,0,8
2341,07/04/2009,3994,4040,3910,3930,416,-286,204,334,-64,0,0,8
2342,08/04/2009,3930,3940,3876,3926,-227,16,305,94,-4,0,0,7
2343,09/04/2009,3926,3986,3912,3984,-170,-211,295,-86,58,0,0,6
2344,14/04/2009,3984,4040,3940,3989,27,-182,35,-120,5,0,0,5
2345,15/04/2009,3989,4023,3942,3968,303,54,-166,191,-21,0,0,4
2346,16/04/2009,3968,4053,3964,4053,153,-159,46,40,85,0,1,3
2347,17/04/2009,4053,4114,4043,4093,40,-46,182,176,40,0,1,3
2348,20/04/2009,4093,4113,3963,3991,-66,-62,-184,-312,-102,1,0,4
2349,21/04/2009,3991,4019,3897,3988,-46,-209,62,-193,-3,1,0,5
2350,22/04/2009,3988,4036,3948,4031,144,145,62,351,43,0,1,5
2351,23/04/2009,4031,4082,3999,4018,15,63,-13,65,-13,0,0,5
2352,24/04/2009,4018,4156,4018,4156,-148,380,138,370,138,0,1,5
2353,27/04/2009,4156,4179,4089,4167,-568,30,2,-536,11,0,0,6
2354,28/04/2009,4167,4167,4059,4096,-202,-405,-405,-1012,-71,1,0,6
2355,29/04/2009,4096,4193,4090,4190,423,204,-97,530,94,0,1,7
2356,30/04/2009,4190,4294,4190,4244,-162,-133,-29,-324,54,0,0,8
2357,01/05/2009,4244,4252,4211,4243,-19,-126,-141,-286,-1,1,0,7
2358,05/05/2009,4243,4375,4243,4337,146,-15,13,144,94,0,1,7
2359,06/05/2009,4337,4438,4317,4396,209,59,59,327,59,0,1,7
2360,07/05/2009,4396,4521,4380,4399,-152,-27,-27,-206,3,0,0,7
2361,08/05/2009,4399,4488,4399,4462,-320,-266,-108,-694,63,0,0,6
2362,11/05/2009,4462,4470,4402,4436,231,-26,-26,179,-26,0,0,6
2363,12/05/2009,4436,4458,4397,4426,159,-215,-106,-162,-10,1,0,5
2364,13/05/2009,4426,4448,4328,4331,-210,-288,-4,-502,-95,1,0,6
2365,14/05/2009,4331,4371,4295,4363,-227,16,305,94,32,0,1,6
2366,15/05/2009,4363,4401,4317,4348,-235,-100,-196,-531,-15,1,0,6
2367,18/05/2009,4348,4446,4308,4446,273,-143,-52,78,98,0,1,7
2368,19/05/2009,4446,4513,4446,4482,57,186,75,318,36,0,1,7
2369,20/05/2009,4482,4504,4445,4468,-382,-62,128,-316,-14,1,0,7
2370,21/05/2009,4468,4468,4326,4346,147,-405,-421,-679,-122,1,0,7
2371,22/05/2009,4346,4393,4335,4365,114,188,157,459,19,0,1,8
2372,26/05/2009,4365,4424,4295,4412,452,667,374,1493,47,0,1,9
2373,27/05/2009,4412,4440,4390,4416,-102,-268,-440,-810,4,0,0,10
2374,28/05/2009,4416,4416,4341,4388,-246,-508,-423,-1177,-28,1,0,9
2375,29/05/2009,4388,4469,4388,4418,55,-192,41,-96,30,0,0,9
2376,01/06/2009,4418,4518,4418,4506,-54,-306,94,-266,88,0,0,8
2377,02/06/2009,4506,4506,4436,4477,-165,-127,-109,-401,-29,1,0,7
2378,03/06/2009,4477,4477,4359,4383,347,-212,-366,-231,-94,1,0,7
2379,04/06/2009,4383,4436,4360,4387,-135,85,-96,-146,4,0,0,7
2380,05/06/2009,4387,4496,4387,4439,-317,-39,-22,-378,52,0,0,6
2381,08/06/2009,4439,4439,4370,4405,107,419,279,805,-34,0,0,5
2382,09/06/2009,4405,4446,4387,4405,157,296,-87,366,0,0,0,4
2383,10/06/2009,4405,4506,4405,4437,41,-172,-58,-189,32,0,0,3
2384,11/06/2009,4437,4478,4409,4462,-123,-725,240,-608,25,0,0,3
2385,12/06/2009,4462,4472,4427,4442,93,-30,109,172,-20,0,0,2
2386,15/06/2009,4442,4442,4320,4326,-120,31,-95,-184,-116,1,0,2
2387,16/06/2009,4326,4373,4322,4329,333,32,18,383,3,0,1,3
2388,17/06/2009,4329,4329,4255,4278,-86,105,194,213,-51,0,0,3
2389,18/06/2009,4278,4305,4240,4281,17,69,-64,22,3,0,1,2
2390,19/06/2009,4281,4370,4280,4346,-109,277,108,276,65,0,1,3
2391,22/06/2009,4346,4346,4234,4234,-237,-120,-33,-390,-112,1,0,4
2392,23/06/2009,4234,4264,4215,4230,18,-5,86,99,-4,0,0,5
2393,24/06/2009,4230,4293,4218,4280,106,-7,50,149,50,0,1,5
2394,25/06/2009,4280,4290,4213,4253,367,-285,139,221,-27,0,0,6
2395,26/06/2009,4253,4307,4216,4241,46,-291,-230,-475,-12,1,0,6
2396,29/06/2009,4241,4304,4235,4294,-397,409,286,298,53,0,1,7
2397,30/06/2009,4294,4311,4231,4249,-241,98,-48,-191,-45,1,0,7
2398,01/07/2009,4249,4353,4249,4341,-7,-292,162,-137,92,0,0,7
2399,02/07/2009,4341,4341,4231,4234,-42,67,33,58,-107,0,0,7
2400,03/07/2009,4234,4265,4221,4236,-2,-59,205,144,2,0,1,6
2401,06/07/2009,4236,4236,4172,4195,95,-75,105,125,-41,0,0,6
2402,07/07/2009,4195,4242,4184,4187,70,-30,-51,-11,-8,1,0,5
2403,08/07/2009,4187,4198,4131,4140,-70,231,34,195,-47,0,0,6
2404,09/07/2009,4140,4186,4140,4159,146,-139,65,72,19,0,1,5
2405,10/07/2009,4159,4160,4124,4127,80,65,208,353,-32,0,0,6
2406,13/07/2009,4127,4209,4096,4202,277,60,-12,325,75,0,1,5
2407,14/07/2009,4202,4256,4199,4238,-60,449,234,623,36,0,1,5
2408,15/07/2009,4238,4346,4238,4346,215,7,138,360,108,0,1,5
2409,16/07/2009,4346,4385,4329,4362,-283,112,16,-155,16,0,0,6
2410,17/07/2009,4362,4412,4362,4389,-163,50,27,-86,27,0,0,6
2411,20/07/2009,4389,4465,4389,4444,-68,111,27,70,55,0,1,5
2412,21/07/2009,4444,4502,4438,4481,67,143,143,353,37,0,1,6
2413,22/07/2009,4481,4498,4449,4494,212,123,19,354,13,0,1,6
2414,23/07/2009,4494,4567,4472,4560,-290,-56,-2,-348,66,0,0,7
2415,24/07/2009,4560,4603,4536,4577,87,-53,-53,-19,17,0,0,6
2416,27/07/2009,4577,4615,4553,4586,-367,-149,117,-399,9,0,0,6
2417,28/07/2009,4586,4616,4520,4529,-283,-75,-113,-471,-57,1,0,5
2418,29/07/2009,4529,4582,4512,4548,147,179,223,549,19,0,1,5
2419,30/07/2009,4548,4647,4548,4632,416,33,182,631,84,0,1,5
2420,31/07/2009,4632,4646,4600,4608,-61,73,22,34,-24,0,0,6
2421,03/08/2009,4608,4710,4596,4682,17,71,-100,-12,74,0,0,6
2422,04/08/2009,4682,4682,4628,4671,-162,-28,-123,-313,-11,1,0,5
2423,05/08/2009,4671,4697,4631,4647,-466,361,237,132,-24,0,0,5
2424,06/08/2009,4647,4730,4647,4690,-131,271,100,240,43,0,1,4
2425,07/08/2009,4690,4744,4632,4732,-382,-62,128,-316,42,0,0,5
2426,10/08/2009,4732,4732,4689,4722,7,-388,-87,-468,-10,1,0,5
2427,11/08/2009,4722,4744,4658,4671,-433,-414,91,-756,-51,1,0,6
2428,12/08/2009,4671,4722,4632,4717,-601,-211,-314,-1126,46,0,0,6
2429,13/08/2009,4717,4790,4717,4756,-170,-478,216,-432,39,0,0,5
2430,14/08/2009,4756,4790,4700,4714,-268,-219,-259,-746,-42,1,0,4
2431,17/08/2009,4714,4714,4610,4645,-219,89,38,-92,-69,1,0,5
2432,18/08/2009,4645,4688,4645,4686,37,494,59,590,41,0,1,6
2433,19/08/2009,4686,4698,4625,4690,-147,43,-134,-238,4,0,0,6
2434,20/08/2009,4690,4767,4690,4757,-94,43,110,59,67,0,1,6
2435,21/08/2009,4757,4858,4736,4851,52,131,186,369,94,0,1,6
2436,24/08/2009,4851,4911,4851,4896,-639,-231,-167,-1037,45,0,0,7
2437,25/08/2009,4896,4923,4859,4917,-35,6,21,-8,21,0,0,6
2438,26/08/2009,4917,4927,4872,4891,-23,18,18,13,-26,0,0,5
2439,27/08/2009,4891,4906,4855,4869,-224,-113,-79,-416,-22,1,0,5
2440,28/08/2009,4869,4944,4869,4909,162,-300,22,-116,40,0,0,6
2441,01/09/2009,4909,4921,4820,4820,-115,-541,-136,-792,-89,1,0,5
2442,02/09/2009,4820,4822,4776,4818,-230,15,-139,-354,-2,1,0,5
2443,03/09/2009,4818,4842,4789,4797,111,-130,-209,-228,-21,1,0,5
2444,04/09/2009,4797,4874,4797,4852,-148,121,109,82,55,0,1,6
2445,07/09/2009,4852,4942,4852,4933,44,-37,-128,-121,81,0,0,6
2446,08/09/2009,4933,4972,4926,4947,100,-217,-66,-183,14,0,0,5
2447,09/09/2009,4947,5004,4928,5004,-377,7,-92,-462,57,0,0,5
2448,10/09/2009,5004,5035,4957,4988,-312,101,101,-110,-16,1,0,5
2449,11/09/2009,4988,5039,4988,5012,-155,160,241,246,24,0,1,6
2450,14/09/2009,5012,5021,4954,5019,-115,-288,-166,-569,7,0,0,6
2451,15/09/2009,5019,5063,4996,5042,7,102,165,274,23,0,1,6
2452,16/09/2009,5042,5131,5042,5124,-111,-338,-87,-536,82,0,0,6
2453,17/09/2009,5124,5173,5124,5164,187,23,23,233,40,0,1,5
2454,18/09/2009,5164,5184,5147,5173,34,18,18,70,9,0,1,5
2455,21/09/2009,5173,5182,5108,5134,-632,-274,-244,-1150,-39,1,0,5
2456,22/09/2009,5134,5190,5134,5143,-549,42,-20,-527,9,0,0,6
2457,23/09/2009,5143,5175,5127,5139,379,76,-24,431,-4,0,0,6
2458,24/09/2009,5139,5165,5073,5079,-263,109,150,-4,-60,1,0,6
2459,25/09/2009,5079,5122,5079,5082,-119,-139,77,-181,3,0,0,6
2460,28/09/2009,5082,5171,5051,5166,286,-53,93,326,84,0,1,5
2461,29/09/2009,5166,5184,5136,5160,209,299,20,528,-6,0,0,6
2462,30/09/2009,5160,5190,5093,5134,-228,-101,-132,-461,-26,1,0,5
2463,01/10/2009,5134,5164,5044,5048,-284,-413,-228,-925,-86,1,0,6
2464,02/10/2009,5048,5048,4955,4989,241,110,-142,209,-59,0,0,6
2465,05/10/2009,4989,5024,4977,5024,-77,36,96,55,35,0,1,5
2466,06/10/2009,5024,5150,5024,5138,-86,25,322,261,114,0,1,5
2467,07/10/2009,5138,5156,5104,5109,16,-374,-36,-394,-29,1,0,6
2468,08/10/2009,5109,5173,5109,5155,-13,-708,-112,-833,46,0,0,7
2469,09/10/2009,5155,5172,5130,5162,174,-398,-343,-567,7,0,0,6
2470,12/10/2009,5162,5231,5162,5210,295,142,-55,382,48,0,1,6
2471,13/10/2009,5210,5222,5154,5154,44,-249,-8,-213,-56,1,0,6
2472,14/10/2009,5154,5261,5154,5256,490,269,-2,757,102,0,1,7
2473,15/10/2009,5256,5268,5219,5223,-632,139,-89,-582,-33,1,0,7
2474,16/10/2009,5223,5273,5176,5190,-406,-82,-15,-503,-33,1,0,7
2475,19/10/2009,5190,5282,5190,5282,355,209,530,1094,92,0,1,8
2476,20/10/2009,5282,5298,5243,5243,243,-275,-16,-48,-39,1,0,8
2477,21/10/2009,5243,5268,5174,5258,391,-26,150,515,15,0,1,8
2478,22/10/2009,5258,5258,5166,5207,36,28,150,214,-51,0,0,8
2479,23/10/2009,5207,5300,5207,5243,-22,260,-173,65,36,0,1,8
2480,26/10/2009,5243,5281,5166,5192,21,-195,-112,-286,-51,1,0,9
2481,27/10/2009,5192,5231,5182,5201,199,91,83,373,9,0,1,9
2482,28/10/2009,5201,5201,5074,5080,342,-142,93,293,-121,0,0,9
2483,29/10/2009,5080,5146,5043,5138,33,161,58,252,58,0,1,8
2484,30/10/2009,5138,5170,5024,5044,-24,188,1,165,-94,0,0,8
2485,02/11/2009,5044,5116,5022,5104,17,54,60,131,60,0,1,7
2486,03/11/2009,5104,5104,4985,5037,-361,54,-345,-652,-67,1,0,7
2487,04/11/2009,5037,5121,5037,5108,-15,69,-283,-229,71,0,0,7
2488,05/11/2009,5107,5155,5037,5126,-147,4,62,-81,19,0,0,6
2489,06/11/2009,5126,5159,5078,5143,-136,-64,-65,-265,17,0,0,6
2490,09/11/2009,5143,5240,5143,5235,94,-87,118,125,92,0,1,5
2491,10/11/2009,5235,5264,5222,5230,139,123,20,282,-5,0,0,5
2492,11/11/2009,5230,5301,5230,5267,48,-8,-68,-28,37,0,0,4
2493,12/11/2009,5267,5305,5254,5276,160,-37,41,164,9,0,1,4
2494,13/11/2009,5276,5297,5251,5296,-133,172,-24,15,20,0,1,4
2495,16/11/2009,5296,5397,5296,5383,-316,137,115,-64,87,0,0,5
2496,17/11/2009,5383,5383,5337,5346,-301,-45,-45,-391,-37,1,0,4
2497,18/11/2009,5346,5372,5332,5342,-130,-34,-72,-236,-4,1,0,4
2498,19/11/2009,5342,5344,5254,5268,104,-197,126,33,-74,0,0,5
2499,20/11/2009,5268,5309,5224,5251,-22,-48,-268,-338,-17,1,0,5
2500,23/11/2009,5251,5380,5251,5356,-1,187,180,366,105,0,1,6
2501,24/11/2009,5356,5375,5309,5324,-9,74,69,134,-32,0,0,6
2502,25/11/2009,5324,5372,5324,5365,-12,-236,52,-196,41,0,0,6
2503,26/11/2009,5365,5365,5189,5194,-90,-166,-179,-435,-171,1,0,6
2504,27/11/2009,5194,5271,5104,5246,59,102,12,173,52,0,1,6
2505,30/11/2009,5246,5270,5191,5191,94,210,245,549,-55,0,0,6
2506,01/12/2009,5191,5312,5191,5312,255,398,121,774,121,0,1,6
2507,02/12/2009,5312,5348,5283,5327,-4,54,225,275,15,0,1,6
2508,03/12/2009,5327,5372,5312,5313,34,-495,-79,-540,-14,1,0,6
2509,04/12/2009,5313,5374,5273,5322,79,300,192,571,9,0,1,7
2510,07/12/2009,5322,5329,5251,5311,11,54,-12,53,-11,0,0,7
2511,08/12/2009,5311,5323,5206,5223,-219,-139,-194,-552,-88,1,0,6
2512,09/12/2009,5223,5246,5176,5204,133,94,5,232,-19,0,0,7
2513,10/12/2009,5204,5254,5194,5244,70,47,99,216,40,0,1,7
2514,11/12/2009,5244,5312,5244,5262,181,-7,-124,50,18,0,1,7
2515,14/12/2009,5262,5331,5262,5315,-127,353,-177,49,53,0,1,7
2516,15/12/2009,5315,5328,5251,5286,335,235,-117,453,-29,0,0,8
2517,16/12/2009,5286,5335,5284,5320,324,179,121,624,34,0,1,7
2518,17/12/2009,5320,5320,5218,5218,-7,42,-67,-32,-102,1,0,7
2519,18/12/2009,5218,5288,5197,5197,10,49,76,135,-21,0,0,7
2520,21/12/2009,5197,5320,5197,5294,70,-21,54,103,97,0,1,6
2521,22/12/2009,5294,5362,5294,5329,-62,-33,-67,-162,35,0,0,7
2522,23/12/2009,5329,5387,5329,5372,-347,7,83,-257,43,0,0,6
2523,24/12/2009,5372,5402,5368,5402,-18,290,103,375,30,0,1,6
2524,29/12/2009,5402,5445,5402,5438,-136,-159,-37,-332,36,0,0,6
2525,30/12/2009,5438,5443,5391,5398,-268,-142,-87,-497,-40,1,0,5
2526,31/12/2009,5398,5432,5390,5413,-549,-472,128,-893,15,0,0,5
2527,04/01/2010,5413,5500,5411,5500,260,80,61,401,87,0,1,5
2528,05/01/2010,5500,5536,5481,5522,-111,5,112,6,22,0,1,5
2529,06/01/2010,5522,5536,5498,5530,-247,11,-42,-278,8,0,0,5
2530,07/01/2010,5530,5552,5500,5527,64,-85,167,146,-3,0,0,5
2531,08/01/2010,5527,5549,5495,5534,-554,-272,-65,-891,7,0,0,4
2532,11/01/2010,5534,5600,5528,5538,-405,-120,-186,-711,4,0,0,4
2533,12/01/2010,5538,5550,5460,5499,302,218,216,736,-39,0,0,4
2534,13/01/2010,5499,5510,5451,5474,-361,-322,94,-589,-25,1,0,3
2535,14/01/2010,5474,5522,5474,5498,-117,-111,139,-89,24,0,0,4
2536,15/01/2010,5498,5527,5450,5455,-233,148,25,-60,-43,1,0,3
2537,18/01/2010,5455,5504,5454,5494,85,-114,237,208,39,0,1,4
2538,19/01/2010,5494,5532,5431,5513,110,-263,-102,-255,19,0,0,4
2539,20/01/2010,5513,5513,5404,5421,-98,-542,102,-538,-92,1,0,3
2540,21/01/2010,5421,5468,5332,5335,-46,45,-185,-186,-86,1,0,4
2541,22/01/2010,5335,5346,5253,5303,-2,53,-115,-64,-32,1,0,5
2542,25/01/2010,5303,5331,5253,5260,-27,359,4,336,-43,0,0,6
2543,26/01/2010,5260,5277,5216,5277,210,-382,-133,-305,17,0,0,6
2544,27/01/2010,5277,5277,5193,5218,-300,86,-119,-333,-59,1,0,6
2545,28/01/2010,5218,5280,5146,5146,-5,-111,-72,-188,-72,1,0,6
2546,29/01/2010,5146,5230,5146,5188,217,73,93,383,42,0,1,7
2547,01/02/2010,5188,5250,5164,5247,-41,23,124,106,59,0,1,7
2548,02/02/2010,5247,5289,5208,5283,-283,-203,-12,-498,36,0,0,7
2549,03/02/2010,5283,5305,5238,5253,-29,-289,68,-250,-30,1,0,7
2550,04/02/2010,5253,5262,5124,5139,-410,-140,-118,-668,-114,1,0,7
2551,05/02/2010,5139,5139,5034,5061,121,-103,-31,-13,-78,1,0,7
2552,08/02/2010,5061,5118,5033,5092,55,112,232,399,31,0,1,7
2553,09/02/2010,5092,5133,5085,5112,-159,404,167,412,20,0,1,8
2554,10/02/2010,5112,5181,5105,5132,92,329,103,524,20,0,1,9
2555,11/02/2010,5132,5202,5114,5162,118,178,354,650,30,0,1,9
2556,12/02/2010,5162,5208,5117,5142,-293,-181,-226,-700,-20,1,0,9
2557,15/02/2010,5142,5194,5142,5168,167,-292,237,112,26,0,1,9
2558,16/02/2010,5168,5248,5168,5244,422,52,68,542,76,0,1,9
2559,17/02/2010,5244,5304,5244,5277,92,-47,-233,-188,33,0,0,10
2560,18/02/2010,5277,5326,5262,5325,437,248,252,937,48,0,1,9
2561,19/02/2010,5325,5366,5281,5358,49,-28,33,54,33,0,1,9
2562,22/02/2010,5358,5387,5348,5352,-35,-16,52,1,-6,0,0,9
2563,23/02/2010,5352,5396,5302,5315,177,258,5,440,-37,0,0,8
2564,24/02/2010,5315,5358,5298,5343,509,-82,-7,420,28,0,1,7
2565,25/02/2010,5343,5370,5260,5278,-221,134,-62,-149,-65,1,0,7
2566,26/02/2010,5278,5368,5278,5354,-282,94,266,78,76,0,1,7
2567,01/03/2010,5354,5421,5354,5406,-9,2,126,119,52,0,1,7
2568,02/03/2010,5406,5485,5404,5484,-165,178,214,227,78,0,1,7
2569,03/03/2010,5484,5542,5465,5533,-272,96,76,-100,49,0,0,7
2570,04/03/2010,5533,5544,5501,5527,-35,87,87,139,-6,0,0,7
2571,05/03/2010,5527,5605,5527,5600,124,-131,-66,-73,73,0,0,6
2572,08/03/2010,5600,5621,5579,5607,-3,-24,-24,-51,7,0,0,5
2573,09/03/2010,5607,5618,5563,5602,-189,-22,-22,-233,-5,1,0,5
2574,10/03/2010,5602,5645,5585,5641,235,-264,-88,-117,39,0,0,6
2575,11/03/2010,5641,5643,5595,5617,-283,-249,-210,-742,-24,1,0,5
2576,12/03/2010,5617,5647,5612,5626,-415,-103,-351,-869,9,0,0,5
2577,15/03/2010,5626,5627,5588,5594,379,-30,136,485,-32,0,0,4
2578,16/03/2010,5594,5638,5594,5620,108,-211,-437,-540,26,0,0,3
2579,17/03/2010,5620,5658,5620,5645,-36,67,128,159,25,0,1,2
2580,18/03/2010,5645,5661,5619,5643,-391,-189,-84,-664,-2,1,0,3
2581,19/03/2010,5643,5691,5634,5650,-191,-12,-250,-453,7,0,0,4
2582,22/03/2010,5650,5650,5584,5644,-76,52,-48,-72,-6,1,0,4
2583,23/03/2010,5644,5696,5644,5674,-168,56,331,219,30,0,1,5
2584,24/03/2010,5674,5699,5636,5678,-443,144,-114,-413,4,0,0,5
2585,25/03/2010,5678,5737,5673,5728,-443,162,-138,-419,50,0,0,5
2586,26/03/2010,5728,5728,5696,5703,-317,-438,-193,-948,-25,1,0,4
2587,29/03/2010,5703,5733,5685,5711,391,-394,-311,-314,8,0,0,5
2588,30/03/2010,5711,5743,5663,5672,-162,-495,-48,-705,-39,1,0,5
2589,31/03/2010,5672,5698,5646,5680,-257,-256,-182,-695,8,0,0,6
2590,01/04/2010,5680,5745,5680,5745,-331,-661,107,-885,65,0,0,5
2591,06/04/2010,5745,5790,5745,5780,86,-347,-65,-326,35,0,0,4
2592,07/04/2010,5780,5782,5753,5762,-317,-190,19,-488,-18,1,0,4
2593,08/04/2010,5762,5762,5684,5713,347,-97,-41,209,-49,0,0,4
2594,09/04/2010,5713,5774,5713,5771,406,118,50,574,58,0,1,3
2595,12/04/2010,5771,5804,5756,5778,-263,280,73,90,7,0,1,4
2596,13/04/2010,5778,5779,5742,5762,-73,141,21,89,-16,0,0,5
2597,14/04/2010,5762,5813,5762,5796,-27,32,-174,-169,34,0,0,4
2598,15/04/2010,5796,5832,5778,5825,89,-324,2,-233,29,0,0,4
2599,16/04/2010,5825,5834,5726,5744,-15,-65,-105,-185,-81,1,0,3
2600,19/04/2010,5744,5748,5697,5728,-229,535,-81,225,-16,0,0,4
2601,20/04/2010,5728,5797,5728,5784,-26,531,-25,480,56,0,1,4
2602,21/04/2010,5784,5797,5721,5723,207,-508,261,-40,-61,1,0,5
2603,22/04/2010,5723,5761,5652,5665,54,524,16,594,-58,0,0,5
2604,23/04/2010,5665,5741,5665,5724,18,-177,-44,-203,59,0,0,5
2605,26/04/2010,5724,5801,5724,5754,342,11,44,397,30,0,1,4
2606,27/04/2010,5754,5759,5604,5604,1,20,-200,-179,-150,1,0,4
2607,28/04/2010,5604,5640,5534,5587,189,-221,189,157,-17,0,0,5
2608,29/04/2010,5587,5639,5580,5618,274,-59,261,476,31,0,1,5
2609,30/04/2010,5618,5644,5541,5553,-353,6,47,-300,-65,1,0,6
2610,04/05/2010,5553,5566,5399,5411,-134,99,-106,-141,-142,1,0,6
2611,05/05/2010,5411,5429,5305,5342,-69,-348,-69,-486,-69,1,0,7
2612,06/05/2010,5342,5372,5251,5261,-74,-131,-74,-279,-81,1,0,7
2613,07/05/2010,5261,5264,5045,5123,-138,-98,-138,-374,-138,1,0,7
2614,10/05/2010,5123,5400,5123,5387,264,682,264,1210,264,0,1,8
2615,11/05/2010,5387,5387,5257,5334,20,-109,185,96,-53,0,0,9
2616,12/05/2010,5334,5401,5285,5384,-95,94,274,273,50,0,1,8
2617,13/05/2010,5384,5436,5382,5434,127,-31,306,402,50,0,1,8
2618,14/05/2010,5434,5434,5245,5263,-481,-121,-495,-1097,-171,1,0,9
2619,17/05/2010,5263,5328,5232,5262,412,76,221,709,-1,0,0,9
2620,18/05/2010,5262,5341,5262,5307,-145,42,32,-71,45,0,0,8
2621,19/05/2010,5307,5307,5158,5158,-111,-140,-108,-359,-149,1,0,7
2622,20/05/2010,5158,5230,5001,5073,-251,-85,213,-123,-85,1,0,7
2623,21/05/2010,5073,5084,4957,5063,-10,36,-16,10,-10,0,0,7
2624,24/05/2010,5063,5109,5022,5070,-58,59,-52,-51,7,0,0,6
2625,25/05/2010,5070,5070,4898,4941,17,-219,-121,-323,-129,1,0,5
2626,26/05/2010,4941,5098,4940,5038,122,-136,122,108,97,0,1,6
2627,27/05/2010,5038,5195,5038,5195,255,1,223,479,157,0,1,6
2628,28/05/2010,5195,5240,5186,5188,-538,-52,-217,-807,-7,1,0,6
2629,01/06/2010,5188,5192,5063,5163,15,-262,-217,-464,-25,1,0,6
2630,02/06/2010,5163,5163,5072,5151,538,-22,-40,476,-12,0,0,7
2631,03/06/2010,5151,5262,5151,5211,97,229,364,690,60,0,1,7
2632,04/06/2010,5211,5262,5102,5126,-70,-295,53,-312,-85,1,0,7
2633,07/06/2010,5126,5126,5040,5069,56,-29,-49,-22,-57,1,0,7
2634,08/06/2010,5069,5084,4985,5028,22,102,164,288,-41,0,0,8
2635,09/06/2010,5028,5086,4998,5086,-102,115,131,144,58,0,1,8
2636,10/06/2010,5086,5150,5031,5132,174,25,114,313,46,0,1,8
2637,11/06/2010,5132,5184,5117,5164,-111,74,85,48,32,0,1,8
2638,14/06/2010,5164,5215,5164,5202,335,131,-68,398,38,0,1,8
2639,15/06/2010,5202,5242,5149,5218,-207,71,-3,-139,16,0,0,8
2640,16/06/2010,5218,5257,5209,5238,-94,-78,88,-84,20,0,0,7
2641,17/06/2010,5238,5294,5233,5254,1,-441,-4,-444,16,0,0,7
2642,18/06/2010,5254,5289,5239,5251,-136,245,7,116,-3,0,0,6
2643,21/06/2010,5251,5332,5251,5299,-469,293,265,89,48,0,1,5
2644,22/06/2010,5299,5299,5210,5247,-162,-375,-367,-904,-52,1,0,5
2645,23/06/2010,5247,5248,5166,5178,439,181,-69,551,-69,0,0,6
2646,24/06/2010,5178,5212,5091,5100,119,704,4,827,-78,0,0,5
2647,25/06/2010,5100,5130,5032,5046,99,-54,-145,-100,-54,1,0,4
2648,28/06/2010,5046,5086,5025,5072,-247,86,26,-135,26,0,0,4
2649,29/06/2010,5072,5072,4899,4914,-180,-114,12,-282,-158,1,0,3
2650,30/06/2010,4914,4962,4898,4917,3,117,3,123,3,0,1,4
2651,01/07/2010,4917,4917,4790,4806,-71,-80,-111,-262,-111,1,0,5
2652,02/07/2010,4806,4881,4806,4838,32,522,32,586,32,0,1,6
2653,05/07/2010,4838,4863,4821,4824,-161,-80,-14,-255,-14,1,0,7
2654,06/07/2010,4824,4968,4824,4965,68,236,185,489,141,0,1,7
2655,07/07/2010,4965,5015,4892,5015,108,-619,65,-446,50,0,0,7
2656,08/07/2010,5015,5124,5015,5106,161,233,189,583,91,0,1,7
2657,09/07/2010,5106,5151,5099,5133,27,139,27,193,27,0,1,8
2658,12/07/2010,5133,5193,5129,5167,34,109,34,177,34,0,1,8
2659,13/07/2010,5167,5272,5167,5271,104,78,104,286,104,0,1,9
2660,14/07/2010,5271,5287,5206,5254,-17,-17,-17,-51,-17,1,0,9
2661,15/07/2010,5254,5268,5188,5211,-43,10,-43,-76,-43,1,0,9
2662,16/07/2010,5211,5274,5153,5159,-277,-1,-52,-330,-52,1,0,9
2663,19/07/2010,5159,5197,5112,5148,-481,59,345,-77,-11,1,0,9
2664,20/07/2010,5148,5180,5091,5140,-29,-36,-1,-66,-8,1,0,9
2665,21/07/2010,5140,5245,5140,5215,264,-16,87,335,75,0,1,9
2666,22/07/2010,5215,5320,5181,5314,198,411,275,884,99,0,1,10
2667,23/07/2010,5314,5328,5273,5313,-125,-44,-57,-226,-1,1,0,10
2668,26/07/2010,5313,5352,5301,5351,-155,362,-358,-151,38,0,0,10
2669,27/07/2010,5351,5412,5351,5366,-125,116,-5,-14,15,0,0,9
2670,28/07/2010,5366,5398,5315,5320,-333,-579,-579,-1491,-46,1,0,8
2671,29/07/2010,5320,5375,5314,5314,115,-37,36,114,-6,0,0,8
2672,30/07/2010,5314,5323,5246,5258,217,-324,93,-14,-56,1,0,7
2673,02/08/2010,5258,5402,5258,5397,-287,102,305,120,139,0,1,7
2674,03/08/2010,5397,5397,5354,5396,40,-541,-111,-612,-1,1,0,7
2675,04/08/2010,5396,5407,5319,5386,-550,-464,139,-875,-10,1,0,7
2676,05/08/2010,5386,5417,5357,5366,42,-495,-187,-640,-20,1,0,7
2677,06/08/2010,5366,5408,5308,5332,207,128,-124,211,-34,0,0,7
2678,09/08/2010,5332,5419,5332,5410,-133,-470,311,-292,78,0,0,6
2679,10/08/2010,5410,5412,5348,5376,73,119,-69,123,-34,0,0,6
2680,11/08/2010,5376,5376,5245,5245,-202,-36,-190,-428,-131,1,0,6
2681,12/08/2010,5245,5272,5210,5266,21,110,300,431,21,0,1,6
2682,13/08/2010,5266,5309,5226,5275,-161,-154,-55,-370,9,0,0,7
2683,16/08/2010,5275,5305,5229,5276,177,226,2,405,1,0,1,6
2684,17/08/2010,5276,5352,5276,5350,-35,19,7,-9,74,0,0,6
2685,18/08/2010,5350,5350,5297,5303,139,105,-210,34,-47,0,0,5
2686,19/08/2010,5303,5336,5206,5211,104,-470,-88,-454,-92,1,0,4
2687,20/08/2010,5211,5233,5160,5195,-56,-177,79,-154,-16,1,0,4
2688,23/08/2010,5195,5268,5187,5235,405,-162,-92,151,40,0,1,5
2689,24/08/2010,5235,5235,5110,5156,-338,-96,64,-370,-79,1,0,6
2690,25/08/2010,5156,5168,5071,5109,-215,-100,-84,-399,-47,1,0,7
2691,26/08/2010,5109,5168,5109,5156,-70,-287,4,-353,47,0,0,7
2692,27/08/2010,5156,5212,5121,5202,-27,-30,-28,-85,46,0,0,6
2693,31/08/2010,5202,5225,5130,5225,-61,-5,-168,-234,23,0,0,6
2694,01/09/2010,5225,5366,5225,5366,56,-383,299,-28,141,0,0,5
2695,02/09/2010,5366,5384,5347,5371,17,32,27,76,5,0,1,5
2696,03/09/2010,5371,5454,5371,5428,70,148,123,341,57,0,1,6
2697,06/09/2010,5428,5459,5428,5439,67,143,143,353,11,0,1,6
2698,07/09/2010,5439,5439,5381,5408,-290,-43,-43,-376,-31,1,0,6
2699,08/09/2010,5408,5446,5361,5430,-23,368,111,456,22,0,1,6
2700,09/09/2010,5430,5506,5412,5494,-80,-83,111,-52,64,0,0,6
2701,10/09/2010,5494,5512,5476,5502,-162,-58,-96,-316,8,0,0,5
2702,13/09/2010,5502,5571,5502,5566,-314,178,117,-19,64,0,0,5
2703,14/09/2010,5566,5582,5542,5567,-163,90,52,-21,1,0,0,5
2704,15/09/2010,5567,5579,5536,5556,64,33,8,105,-11,0,0,5
2705,16/09/2010,5556,5564,5534,5540,-415,-35,75,-375,-16,1,0,5
2706,17/09/2010,5540,5613,5508,5508,60,-99,122,83,-32,0,0,5
2707,20/09/2010,5508,5607,5508,5602,157,483,102,742,94,0,1,4
2708,21/09/2010,5602,5636,5576,5576,-90,415,143,468,-26,0,0,4
2709,22/09/2010,5576,5598,5517,5552,490,194,314,998,-24,0,0,3
2710,23/09/2010,5552,5589,5472,5547,-187,-841,-411,-1439,-5,1,0,2
2711,24/09/2010,5547,5612,5516,5598,-313,50,-129,-392,51,0,0,3
2712,27/09/2010,5598,5616,5570,5573,-23,-189,-91,-303,-25,1,0,3
2713,28/09/2010,5573,5582,5506,5578,-136,-211,-121,-468,5,0,0,4
2714,29/09/2010,5578,5624,5545,5569,70,285,-321,34,-9,0,0,4
2715,30/09/2010,5569,5650,5539,5549,-26,-265,167,-124,-20,1,0,4
2716,01/10/2010,5549,5615,5548,5593,133,-389,-169,-425,44,0,0,4
2717,04/10/2010,5593,5601,5551,5556,25,-405,208,-172,-37,1,0,4
2718,05/10/2010,5556,5646,5551,5636,-73,-49,-170,-292,80,0,0,4
2719,06/10/2010,5636,5696,5636,5681,245,-67,-23,155,45,0,1,4
2720,07/10/2010,5681,5707,5651,5662,313,-526,-55,-268,-19,1,0,5
2721,08/10/2010,5662,5664,5607,5658,17,-30,23,10,-4,0,0,5
2722,11/10/2010,5658,5686,5656,5672,386,-405,123,104,14,0,1,5
2723,12/10/2010,5672,5677,5598,5662,-295,84,214,3,-10,0,0,5
2724,13/10/2010,5662,5760,5662,5747,-27,81,-82,-28,85,0,0,5
2725,14/10/2010,5747,5771,5713,5727,-153,-407,-285,-845,-20,1,0,5
2726,15/10/2010,5727,5744,5666,5703,-21,-38,-90,-149,-24,1,0,5
2727,18/10/2010,5703,5749,5670,5742,280,-10,5,275,39,0,1,6
2728,19/10/2010,5742,5762,5691,5704,-470,30,-22,-462,-38,1,0,6
2729,20/10/2010,5704,5730,5680,5729,35,-182,-168,-315,25,0,0,7
2730,21/10/2010,5729,5787,5698,5758,78,84,-88,74,29,0,1,6
2731,22/10/2010,5758,5758,5724,5741,52,-196,14,-130,-17,1,0,6
2732,25/10/2010,5741,5794,5741,5752,-191,256,-177,-112,11,0,0,7
2733,26/10/2010,5752,5754,5677,5707,150,-129,-136,-115,-45,1,0,6
2734,27/10/2010,5707,5707,5631,5646,-43,-281,-74,-398,-61,1,0,7
2735,28/10/2010,5646,5712,5646,5678,82,46,159,287,32,0,1,8
2736,29/10/2010,5678,5699,5647,5675,38,531,117,686,-3,0,0,8
2737,01/11/2010,5675,5733,5667,5695,62,284,370,716,20,0,1,7
2738,02/11/2010,5695,5772,5690,5757,87,-185,-102,-200,62,0,0,7
2739,03/11/2010,5757,5774,5730,5749,-12,-456,87,-381,-8,1,0,6
2740,04/11/2010,5749,5876,5749,5863,322,180,197,699,114,0,1,7
2741,05/11/2010,5863,5899,5834,5875,-351,152,48,-151,12,0,0,7
2742,08/11/2010,5875,5881,5841,5850,-272,-145,-50,-467,-25,1,0,6
2743,09/11/2010,5850,5902,5847,5875,-212,17,-160,-355,25,0,0,7
2744,10/11/2010,5875,5877,5796,5817,18,42,-111,-51,-58,1,0,6
2745,11/11/2010,5817,5846,5793,5815,345,109,248,702,-2,0,0,6
2746,12/11/2010,5815,5832,5712,5797,-241,67,208,34,-18,0,0,5
2747,15/11/2010,5797,5833,5756,5820,-147,-69,-170,-386,23,0,0,5
2748,16/11/2010,5820,5820,5681,5682,-282,-324,-404,-1010,-138,1,0,4
2749,17/11/2010,5682,5704,5660,5693,-87,-6,107,14,11,0,1,5
2750,18/11/2010,5693,5783,5693,5769,-37,73,-145,-109,76,0,0,5
2751,19/11/2010,5769,5774,5684,5733,-151,-53,292,88,-36,0,0,4
2752,22/11/2010,5733,5783,5668,5681,47,-114,116,49,-52,0,0,4
2753,23/11/2010,5681,5681,5581,5581,435,-59,-100,276,-100,0,0,3
2754,24/11/2010,5581,5672,5573,5657,69,-166,-133,-230,76,0,0,3
2755,25/11/2010,5657,5708,5655,5699,-68,63,161,156,42,0,1,2
2756,26/11/2010,5699,5699,5599,5669,46,137,-121,62,-30,0,0,3
2757,29/11/2010,5669,5723,5551,5551,-184,-82,43,-223,-118,1,0,3
2758,30/11/2010,5551,5597,5519,5528,69,99,207,375,-23,0,0,4
2759,01/12/2010,5528,5656,5528,5642,150,-156,-30,-36,114,0,0,3
2760,02/12/2010,5642,5771,5642,5768,-56,435,301,680,126,0,1,2
2761,03/12/2010,5768,5784,5720,5745,-62,-146,1,-207,-23,1,0,3
2762,06/12/2010,5745,5786,5728,5770,-113,15,-31,-129,25,0,0,4
2763,07/12/2010,5770,5850,5770,5808,-17,56,2,41,38,0,1,4
2764,08/12/2010,5808,5827,5774,5794,437,-149,-125,163,-14,0,0,5
2765,09/12/2010,5794,5838,5794,5808,-45,-249,17,-277,14,0,0,5
2766,10/12/2010,5808,5828,5794,5813,-142,-90,-31,-263,5,0,0,4
2767,13/12/2010,5813,5874,5813,5861,182,305,133,620,48,0,1,4
2768,14/12/2010,5861,5891,5847,5891,63,54,-111,6,30,0,1,4
2769,15/12/2010,5891,5898,5858,5882,-111,93,-7,-25,-9,1,0,5
2770,16/12/2010,5882,5907,5863,5881,-21,-203,-50,-274,-1,1,0,6
2771,17/12/2010,5881,5902,5857,5872,331,11,79,421,-9,0,0,6
2772,20/12/2010,5872,5914,5866,5892,-33,-83,174,58,20,0,1,5
2773,21/12/2010,5892,5954,5891,5952,-364,355,-7,-16,60,0,0,6
2774,22/12/2010,5952,5992,5936,5984,-199,-490,-591,-1280,32,0,0,5
2775,23/12/2010,5984,6000,5982,5996,7,189,23,219,12,0,1,5
2776,24/12/2010,5996,6009,5978,6009,243,160,5,408,13,0,1,6
2777,29/12/2010,6009,6022,5977,5996,-199,-230,-226,-655,-13,1,0,7
2778,30/12/2010,5996,6010,5970,5971,-50,-121,95,-76,-25,1,0,7
2779,31/12/2010,5971,5986,5900,5900,252,54,-29,277,-71,0,0,7
2780,04/01/2011,5900,6050,5900,6014,338,427,225,990,114,0,1,6
2781,05/01/2011,6014,6044,5964,6044,89,-208,-534,-653,30,0,0,6
2782,06/01/2011,6044,6090,6005,6020,-141,-269,-265,-675,-24,1,0,6
2783,07/01/2011,6020,6024,5973,5984,267,-182,9,94,-36,0,0,6
2784,10/01/2011,5984,5984,5940,5956,399,-197,-172,30,-28,0,0,6
2785,11/01/2011,5956,6036,5956,6014,193,396,152,741,58,0,1,6
2786,12/01/2011,6014,6051,6014,6051,-36,67,128,159,37,0,1,6
2787,13/01/2011,6051,6056,6006,6024,73,-372,-23,-322,-27,1,0,6
2788,14/01/2011,6024,6032,5948,6002,-32,218,-44,142,-22,0,0,6
2789,17/01/2011,6002,6013,5976,5986,104,183,107,394,-16,0,0,5
2790,18/01/2011,5986,6066,5986,6056,-43,-281,-74,-398,70,0,0,5
2791,19/01/2011,6056,6077,5975,5977,-364,221,-199,-342,-79,1,0,4
2792,20/01/2011,5977,5978,5867,5868,-101,311,-109,101,-109,0,0,5
2793,21/01/2011,5868,5939,5868,5896,28,-17,28,39,28,0,1,4
2794,24/01/2011,5896,5960,5888,5944,-65,-57,48,-74,48,0,0,5
2795,25/01/2011,5944,5965,5904,5918,-1,-243,-26,-270,-26,1,0,5
2796,26/01/2011,5918,6003,5918,5969,12,108,51,171,51,0,1,5
2797,27/01/2011,5969,5997,5951,5965,-99,-183,-88,-370,-4,1,0,5
2798,28/01/2011,5965,5966,5878,5881,-47,-79,-88,-214,-84,1,0,5
2799,31/01/2011,5881,5882,5815,5863,-24,42,-18,0,-18,0,0,6
2800,01/02/2011,5863,5964,5863,5958,62,157,7,226,95,0,1,6
2801,02/02/2011,5958,6020,5958,6000,239,119,-78,280,42,0,1,7
2802,03/02/2011,6000,6000,5952,5983,-99,70,-349,-378,-17,1,0,7
2803,04/02/2011,5983,6023,5983,5997,34,-48,228,214,14,0,1,8
2804,07/02/2011,5997,6054,5997,6051,98,-121,377,354,54,0,1,8
2805,08/02/2011,6051,6091,6033,6091,-70,-266,-346,-682,40,0,0,9
2806,09/02/2011,6091,6091,6050,6052,-279,-114,-61,-454,-39,1,0,8
2807,10/02/2011,6052,6052,5986,6020,-21,84,-127,-64,-32,1,0,8
2808,11/02/2011,6020,6071,5973,6063,382,275,59,716,43,0,1,8
2809,14/02/2011,6063,6092,6042,6060,-364,342,-343,-365,-3,1,0,8
2810,15/02/2011,6060,6072,6024,6037,59,235,61,355,-23,0,0,9
2811,16/02/2011,6037,6096,6034,6085,26,180,-178,28,48,0,1,8
2812,17/02/2011,6085,6101,6067,6087,209,42,-25,226,2,0,1,8
2813,18/02/2011,6087,6097,6049,6083,-47,-83,121,-9,-4,1,0,8
2814,21/02/2011,6083,6106,6013,6015,163,8,157,328,-68,0,0,8
2815,22/02/2011,6015,6029,5926,5997,-55,130,-215,-140,-18,1,0,7
2816,23/02/2011,5997,5997,5916,5924,60,-67,149,142,-73,0,0,8
2817,24/02/2011,5924,5937,5861,5920,-15,117,-9,93,-4,0,0,7
2818,25/02/2011,5920,6012,5920,6001,56,153,-10,199,81,0,1,6
2819,28/02/2011,6001,6022,5964,5994,-600,412,-412,-600,-7,1,0,6
2820,01/03/2011,5994,6040,5927,5936,-202,-20,-412,-634,-58,1,0,6
2821,02/03/2011,5936,5942,5866,5915,80,-361,-16,-297,-21,1,0,7
2822,03/03/2011,5915,6017,5915,6005,-32,156,253,377,90,0,1,7
2823,04/03/2011,6005,6052,5983,5990,228,112,-15,325,-15,0,0,7
2824,07/03/2011,5990,6043,5968,5974,-43,-365,-153,-561,-16,1,0,6
2825,08/03/2011,5974,6000,5911,5975,0,-743,-483,-1226,1,0,0,7
2826,09/03/2011,5975,5979,5923,5937,-168,-42,-266,-476,-38,1,0,6
2827,10/03/2011,5937,5937,5833,5845,-273,-207,7,-473,-92,1,0,7
2828,11/03/2011,5845,5845,5796,5829,-225,75,216,66,-16,0,0,8
2829,14/03/2011,5829,5842,5769,5775,263,267,156,686,-54,0,0,7
2830,15/03/2011,5775,5775,5592,5695,-54,82,158,186,-80,0,0,6
2831,16/03/2011,5695,5721,5598,5598,49,36,-55,30,-97,0,0,5
2832,17/03/2011,5598,5708,5598,5696,190,270,190,650,98,0,1,4
2833,18/03/2011,5696,5758,5696,5718,-159,-46,-161,-366,22,0,0,4
2834,21/03/2011,5718,5799,5718,5786,412,-20,-46,346,68,0,1,4
2835,22/03/2011,5786,5814,5743,5763,99,-785,173,-513,-23,1,0,4
2836,23/03/2011,5763,5802,5731,5796,-136,-147,-217,-500,33,0,0,5
2837,24/03/2011,5796,5889,5780,5881,139,229,348,716,85,0,1,4
2838,25/03/2011,5881,5919,5878,5901,25,34,42,101,20,0,1,4
2839,28/03/2011,5901,5923,5901,5904,37,21,-87,-29,3,0,0,5
2840,29/03/2011,5904,5933,5880,5932,215,148,42,405,28,0,1,5
2841,30/03/2011,5932,5971,5932,5948,-154,11,58,-85,16,0,0,6
2842,31/03/2011,5948,5973,5909,5909,3,-103,-48,-148,-39,1,0,6
2843,01/04/2011,5909,6015,5909,6010,199,8,411,618,101,0,1,6
2844,04/04/2011,6010,6035,5988,6017,-428,-14,-14,-456,7,0,0,7
2845,05/04/2011,6017,6026,5989,6007,-21,33,8,20,-10,0,0,6
2846,06/04/2011,6007,6056,6007,6041,-442,-190,6,-626,34,0,0,5
2847,07/04/2011,6041,6053,6007,6007,-196,-314,-394,-904,-34,1,0,5
2848,08/04/2011,6007,6066,6007,6056,507,-296,-66,145,49,0,1,5
2849,11/04/2011,6056,6071,6044,6053,-382,229,-28,-181,-3,1,0,5
2850,12/04/2011,6053,6054,5958,5964,-141,99,-62,-104,-89,1,0,6
2851,13/04/2011,5964,6043,5964,6010,-135,320,439,624,46,0,1,6
2852,14/04/2011,6010,6010,5944,5964,-167,87,-421,-501,-46,1,0,7
2853,15/04/2011,5964,5997,5964,5996,49,463,-52,460,32,0,1,7
2854,18/04/2011,5996,5998,5858,5870,148,-389,85,-156,-126,1,0,7
2855,19/04/2011,5870,5922,5870,5897,183,27,27,237,27,0,1,8
2856,20/04/2011,5897,6034,5897,6022,63,344,200,607,125,0,1,9
2857,21/04/2011,6022,6049,6006,6018,16,-326,33,-277,-4,1,0,10
2858,26/04/2011,6018,6071,6007,6069,322,-64,386,644,51,0,1,10
2859,27/04/2011,6069,6089,6046,6068,-179,-109,6,-282,-1,1,0,10
2860,28/04/2011,6068,6092,6051,6070,-415,-94,1,-508,2,0,0,10
2861,03/05/2011,6070,6104,6051,6083,-377,-31,-180,-588,13,0,0,9
2862,04/05/2011,6083,6084,5973,5984,-259,-42,-137,-438,-99,1,0,8
2863,05/05/2011,5984,6009,5913,5920,-229,-22,-168,-419,-64,1,0,8
2864,06/05/2011,5920,5985,5872,5977,109,115,79,303,57,0,1,8
2865,09/05/2011,5977,6000,5922,5943,184,46,63,293,-34,0,0,8
2866,10/05/2011,5943,6023,5940,6019,177,105,68,350,76,0,1,7
2867,11/05/2011,6019,6040,5965,5976,-30,-44,-134,-208,-43,1,0,7
2868,12/05/2011,5976,5976,5882,5945,391,-93,63,361,-31,0,0,7
2869,13/05/2011,5945,6001,5920,5926,114,177,34,325,-19,0,0,6
2870,16/05/2011,5926,5936,5862,5924,-152,97,97,42,-2,0,0,5
2871,17/05/2011,5924,5943,5861,5861,14,-1,43,56,-63,0,0,5
2872,18/05/2011,5861,5934,5861,5924,253,252,103,608,63,0,1,5
2873,19/05/2011,5924,6004,5924,5956,-17,142,-58,67,32,0,1,5
2874,20/05/2011,5956,6018,5928,5948,-194,170,-251,-275,-8,1,0,5
2875,23/05/2011,5948,5948,5833,5836,-50,-894,-379,-1323,-112,1,0,5
2876,24/05/2011,5836,5885,5836,5858,-650,-162,104,-708,22,0,0,6
2877,25/05/2011,5858,5881,5810,5870,-159,77,336,254,12,0,1,5
2878,26/05/2011,5870,5911,5867,5881,118,-187,114,45,11,0,1,5
2879,27/05/2011,5881,5951,5881,5939,249,-31,-215,3,58,0,1,6
2880,31/05/2011,5939,6010,5939,5990,89,201,260,550,51,0,1,7
2881,01/06/2011,5990,5995,5912,5929,220,-179,-64,-23,-61,1,0,8
2882,02/06/2011,5929,5929,5848,5848,-219,52,37,-130,-81,1,0,9
2883,03/06/2011,5848,5868,5803,5855,160,47,-208,-1,7,0,0,9
2884,06/06/2011,5855,5881,5828,5863,430,155,-110,475,8,0,1,8
2885,07/06/2011,5863,5891,5849,5865,273,217,25,515,2,0,1,8
2886,08/06/2011,5865,5865,5792,5809,-322,-239,25,-536,-56,1,0,8
2887,09/06/2011,5809,5861,5795,5856,478,262,176,916,47,0,1,9
2888,10/06/2011,5856,5867,5758,5766,-75,90,-200,-185,-90,1,0,9
2889,13/06/2011,5766,5794,5763,5774,-85,-7,-27,-119,8,0,0,9
2890,14/06/2011,5774,5823,5774,5803,210,-49,131,292,29,0,1,8
2891,15/06/2011,5803,5803,5742,5742,-338,-222,205,-355,-61,1,0,8
2892,16/06/2011,5742,5742,5644,5699,-89,262,-305,-132,-43,1,0,8
2893,17/06/2011,5699,5733,5645,5715,125,143,95,363,16,0,1,8
2894,20/06/2011,5715,5715,5647,5693,8,6,-56,-42,-22,1,0,9
2895,21/06/2011,5693,5778,5693,5775,-355,129,-19,-245,82,0,0,9
2896,22/06/2011,5775,5789,5742,5773,22,-10,-120,-108,-2,1,0,8
2897,23/06/2011,5773,5773,5663,5674,-83,-101,-152,-336,-99,1,0,8
2898,24/06/2011,5674,5768,5674,5698,187,55,-4,238,24,0,1,8
2899,27/06/2011,5698,5728,5680,5722,126,-97,-12,17,24,0,1,8
2900,28/06/2011,5722,5795,5722,5767,-167,-49,-15,-231,45,0,0,9
2901,29/06/2011,5767,5861,5767,5856,517,10,82,609,89,0,1,8
2902,30/06/2011,5856,5946,5856,5946,396,85,-33,448,90,0,1,8
2903,01/07/2011,5946,5999,5937,5990,67,-452,44,-341,44,0,0,8
2904,04/07/2011,5990,6031,5986,6018,-175,28,28,-119,28,0,0,7
2905,05/07/2011,6018,6036,6011,6024,87,123,19,229,6,0,1,6
2906,06/07/2011,6024,6026,5974,6003,-218,130,-4,-92,-21,1,0,7
2907,07/07/2011,6003,6072,6003,6054,132,11,-89,54,51,0,1,7
2908,08/07/2011,6054,6084,5982,5991,33,-43,-96,-106,-63,1,0,7
2909,11/07/2011,5991,5999,5901,5929,49,55,126,230,-62,0,0,7
2910,12/07/2011,5929,5929,5793,5869,33,25,-109,-51,-60,1,0,6
2911,13/07/2011,5869,5911,5851,5906,86,80,59,225,37,0,1,7
2912,14/07/2011,5906,5906,5841,5847,185,-70,-345,-230,-59,1,0,7
2913,15/07/2011,5847,5864,5806,5844,-222,73,96,-53,-3,1,0,7
2914,18/07/2011,5844,5844,5753,5753,-176,110,87,21,-91,0,0,8
2915,19/07/2011,5753,5802,5753,5790,82,37,123,242,37,0,1,8
2916,20/07/2011,5790,5856,5790,5854,-117,76,5,-36,64,0,0,8
2917,21/07/2011,5854,5934,5798,5900,-266,730,-128,336,46,0,1,7
2918,22/07/2011,5900,5967,5900,5935,223,-70,200,353,35,0,1,7
2919,25/07/2011,5935,5938,5893,5925,-71,-464,3,-532,-10,1,0,7
2920,26/07/2011,5925,5951,5896,5930,187,-35,-212,-60,5,0,0,8
2921,27/07/2011,5930,5932,5841,5857,-209,243,-149,-115,-73,1,0,7
2922,28/07/2011,5857,5883,5802,5873,-100,-138,22,-216,16,0,0,7
2923,29/07/2011,5873,5873,5772,5815,50,-153,-153,-256,-58,1,0,6
2924,01/08/2011,5815,5914,5767,5774,3,-73,-193,-263,-41,1,0,6
2925,02/08/2011,5774,5779,5705,5718,-12,-56,-87,-155,-56,1,0,7
2926,03/08/2011,5718,5718,5558,5584,-16,162,-334,-188,-134,1,0,7
2927,04/08/2011,5584,5644,5393,5393,-315,36,-503,-782,-191,1,0,8
2928,05/08/2011,5393,5393,5203,5247,-146,34,-146,-258,-146,1,0,8
2929,08/08/2011,5247,5296,5062,5069,-178,-75,-178,-431,-178,1,0,8
2930,09/08/2011,5069,5176,4791,5165,96,96,96,288,96,0,1,8
2931,10/08/2011,5165,5263,4991,5007,-158,-158,-158,-474,-158,1,0,9
2932,11/08/2011,5007,5173,4943,5163,156,-22,156,290,156,0,1,9
2933,12/08/2011,5163,5320,5099,5320,157,-31,262,388,157,0,1,10
2934,15/08/2011,5320,5377,5319,5351,264,-59,329,534,31,0,1,10
2935,16/08/2011,5351,5362,5266,5358,227,100,98,425,7,0,1,10
2936,17/08/2011,5358,5371,5280,5332,-18,-234,-233,-485,-26,1,0,10
2937,18/08/2011,5332,5332,5042,5092,7,-262,-233,-488,-240,1,0,10
2938,19/08/2011,5092,5108,4930,5041,-479,-51,-50,-580,-51,1,0,10
2939,22/08/2011,5041,5183,4993,5095,878,54,36,968,54,0,1,10
2940,23/08/2011,5095,5193,5077,5129,146,34,-59,121,34,0,1,10
2941,24/08/2011,5129,5251,5098,5206,34,7,-97,-56,77,0,0,10
2942,25/08/2011,5206,5254,5102,5131,-111,-54,-97,-262,-75,1,0,9
2943,26/08/2011,5131,5150,5015,5130,192,105,47,344,-1,0,0,9
2944,30/08/2011,5130,5284,5130,5269,99,121,70,290,139,0,1,8
2945,31/08/2011,5269,5412,5259,5394,1,240,-1,240,125,0,1,8
2946,01/09/2011,5394,5450,5347,5419,33,25,25,83,25,0,1,8
2947,02/09/2011,5419,5419,5258,5292,-127,-127,-127,-381,-127,1,0,8
2948,05/09/2011,5292,5292,5098,5103,-406,178,-288,-516,-189,1,0,8
2949,06/09/2011,5103,5190,5087,5157,19,117,83,219,54,0,1,8
2950,07/09/2011,5157,5322,5157,5319,120,31,281,432,162,0,1,8
2951,08/09/2011,5319,5370,5270,5340,2,-300,-347,-645,21,0,0,8
2952,09/09/2011,5340,5352,5202,5215,-151,-441,-394,-986,-125,1,0,8
2953,12/09/2011,5215,5215,5059,5130,-63,73,273,283,-85,0,0,8
2954,13/09/2011,5130,5203,5070,5174,57,140,78,275,44,0,1,8
2955,14/09/2011,5174,5270,5146,5227,11,-274,56,-207,53,0,0,8
2956,15/09/2011,5227,5367,5227,5338,62,-45,328,345,111,0,1,7
2957,16/09/2011,5338,5406,5338,5368,-92,-416,51,-457,30,0,0,7
2958,19/09/2011,5368,5368,5232,5260,-228,-131,-120,-479,-108,1,0,6
2959,20/09/2011,5260,5377,5219,5364,-290,-416,-150,-856,104,0,0,6
2960,21/09/2011,5364,5366,5269,5288,-316,-725,-257,-1298,-76,1,0,5
2961,22/09/2011,5288,5288,5014,5042,340,-185,-208,-53,-246,1,0,5
2962,23/09/2011,5042,5105,4928,5067,7,36,117,160,25,0,1,6
2963,26/09/2011,5067,5149,4974,5089,-223,-76,-275,-574,22,0,0,6
2964,27/09/2011,5089,5294,5089,5294,-147,-113,-101,-361,205,0,0,6
2965,28/09/2011,5294,5314,5191,5218,-248,-207,-230,-685,-76,1,0,5
2966,29/09/2011,5218,5250,5161,5197,56,-254,306,108,-21,0,0,6
2967,30/09/2011,5197,5197,5069,5128,59,-79,77,57,-69,0,0,5
2968,03/10/2011,5128,5128,4983,5076,-361,61,-3,-303,-52,1,0,5
2969,04/10/2011,5076,5076,4869,4944,-119,-132,-177,-428,-132,1,0,5
2970,05/10/2011,4944,5121,4944,5102,158,-557,333,-66,158,0,0,6
2971,06/10/2011,5102,5291,5102,5291,-562,397,12,-153,189,0,0,5
2972,07/10/2011,5291,5371,5261,5303,12,12,27,51,12,0,1,4
2973,10/10/2011,5303,5413,5303,5399,101,112,156,369,96,0,1,4
2974,11/10/2011,5399,5399,5330,5396,-137,15,15,-107,-3,1,0,5
2975,12/10/2011,5396,5458,5348,5442,50,-451,46,-355,46,0,0,6
2976,13/10/2011,5442,5456,5368,5403,-89,-39,-39,-167,-39,1,0,5
2977,14/10/2011,5403,5501,5396,5466,66,120,63,249,63,0,1,6
2978,17/10/2011,5466,5544,5405,5437,67,-92,-135,-160,-29,1,0,7
2979,18/10/2011,5437,5437,5349,5410,-69,-11,11,-69,-27,1,0,7
2980,19/10/2011,5410,5484,5410,5450,36,128,-191,-27,40,0,0,7
2981,20/10/2011,5450,5450,5363,5385,-207,160,-81,-128,-65,1,0,7
2982,21/10/2011,5385,5500,5385,5489,-119,41,13,-65,104,0,0,8
2983,24/10/2011,5489,5553,5487,5548,245,73,76,394,59,0,1,7
2984,25/10/2011,5548,5574,5466,5526,-153,73,22,-58,-22,1,0,7
2985,26/10/2011,5526,5577,5498,5553,-93,48,90,45,27,0,1,7
2986,27/10/2011,5553,5747,5553,5714,-196,25,265,94,161,0,1,8
2987,28/10/2011,5714,5747,5685,5702,-43,9,9,-25,-12,1,0,8
2988,31/10/2011,5702,5702,5544,5544,15,-216,-154,-355,-158,1,0,8
2989,01/11/2011,5544,5544,5338,5422,-480,-725,-437,-1642,-122,1,0,8
2990,02/11/2011,5422,5493,5383,5484,145,113,131,389,62,0,1,8
2991,03/11/2011,5484,5564,5403,5546,85,458,-52,491,62,0,1,9
2992,04/11/2011,5546,5600,5495,5527,51,-42,62,71,-19,0,0,9
2993,07/11/2011,5527,5558,5432,5511,346,311,65,722,-16,0,0,9
2994,08/11/2011,5511,5616,5510,5567,-55,60,119,124,56,0,1,8
2995,09/11/2011,5567,5616,5426,5460,-70,-73,-2,-145,-107,1,0,8
2996,10/11/2011,5460,5497,5360,5445,465,-91,-32,342,-15,0,0,8
2997,11/11/2011,5445,5549,5440,5545,-151,142,9,0,100,0,0,7
2998,14/11/2011,5545,5575,5489,5519,-60,-289,71,-278,-26,1,0,6
2999,15/11/2011,5519,5551,5429,5517,-265,56,32,-177,-2,1,0,6
3000,16/11/2011,5517,5563,5450,5509,-20,-95,35,-80,-8,1,0,6
3001,17/11/2011,5509,5509,5366,5423,-100,-356,-16,-472,-86,1,0,6
3002,18/11/2011,5423,5423,5348,5363,36,164,25,225,-60,0,0,6
3003,21/11/2011,5363,5363,5222,5223,111,-27,35,119,-140,0,0,6
3004,22/11/2011,5223,5282,5207,5207,30,-370,30,-310,-16,1,0,6
3005,23/11/2011,5207,5207,5140,5140,-72,428,-67,289,-67,0,0,6
3006,24/11/2011,5140,5184,5099,5128,-315,-114,-315,-744,-12,1,0,5
3007,25/11/2011,5128,5200,5075,5165,-202,-310,16,-496,37,0,0,6
3008,28/11/2011,5165,5328,5165,5313,886,6,367,1259,148,0,1,6
3009,29/11/2011,5313,5344,5272,5337,304,69,299,672,24,0,1,6
3010,30/11/2011,5337,5539,5275,5505,137,-262,5,-120,168,0,0,6
3011,01/12/2011,5505,5554,5487,5489,-16,-16,-16,-48,-16,1,0,5
3012,02/12/2011,5489,5596,5489,5552,-54,-53,-54,-161,63,0,0,5
3013,05/12/2011,5552,5603,5546,5568,16,16,16,48,16,0,1,5
3014,06/12/2011,5568,5593,5522,5569,-6,1,1,-4,1,0,0,6
3015,07/12/2011,5569,5632,5498,5547,212,-71,-114,27,-22,0,0,5
3016,08/12/2011,5547,5605,5484,5484,225,11,-120,116,-63,0,0,5
3017,09/12/2011,5484,5540,5441,5529,352,235,412,999,45,0,1,4
3018,12/12/2011,5529,5529,5428,5428,-170,-117,29,-258,-101,1,0,5
3019,13/12/2011,5428,5526,5414,5490,185,54,182,421,62,0,1,5
3020,14/12/2011,5490,5490,5367,5367,273,-9,-22,242,-123,0,0,5
3021,15/12/2011,5367,5434,5367,5401,243,-6,78,315,34,0,1,5
3022,16/12/2011,5401,5453,5387,5387,85,117,-36,166,-14,0,0,5
3023,19/12/2011,5387,5410,5343,5365,-101,-235,-36,-372,-22,1,0,5
3024,20/12/2011,5365,5426,5329,5420,406,108,-36,478,55,0,1,5
3025,21/12/2011,5420,5479,5372,5390,-5,-262,-33,-300,-30,1,0,6
3026,22/12/2011,5390,5469,5390,5457,77,459,239,775,67,0,1,7
3027,23/12/2011,5457,5517,5457,5513,61,-120,383,324,56,0,1,8
3028,28/12/2011,5513,5568,5491,5507,-278,-655,-213,-1146,-6,1,0,8
3029,29/12/2011,5507,5567,5497,5567,20,-344,-193,-517,60,0,0,8
3030,30/12/2011,5567,5588,5535,5572,121,-274,5,-148,5,0,0,7
3031,03/01/2012,5572,5700,5572,5700,-316,144,111,-61,128,0,0,7
3032,04/01/2012,5700,5720,5646,5668,-162,-78,-78,-318,-32,1,0,6
3033,05/01/2012,5668,5689,5614,5624,66,-28,52,90,-44,0,0,7
3034,06/01/2012,5624,5683,5623,5650,135,-15,-28,92,26,0,1,6
3035,09/01/2012,5650,5674,5605,5612,-69,-311,-4,-384,-38,1,0,6
3036,10/01/2012,5612,5712,5612,5697,-185,-44,405,176,85,0,1,6
3037,11/01/2012,5697,5701,5645,5671,-151,257,-4,102,-26,0,0,6
3038,12/01/2012,5671,5700,5640,5662,235,251,-79,407,-9,0,0,5
3039,13/01/2012,5662,5709,5584,5637,-124,-36,96,-64,-25,1,0,4
3040,16/01/2012,5637,5663,5610,5657,-227,96,365,234,20,0,1,5
3041,17/01/2012,5657,5724,5657,5694,-171,119,162,110,37,0,1,6
3042,18/01/2012,5694,5710,5648,5702,275,284,165,724,8,0,1,7
3043,19/01/2012,5702,5744,5693,5741,-324,221,-204,-307,39,0,0,7
3044,20/01/2012,5741,5750,5722,5728,-337,-314,-290,-941,-13,1,0,7
3045,23/01/2012,5728,5790,5723,5783,374,185,136,695,55,0,1,7
3046,24/01/2012,5783,5783,5720,5752,-196,-433,-5,-634,-31,1,0,7
3047,25/01/2012,5752,5778,5694,5723,347,-212,-366,-231,-29,1,0,7
3048,26/01/2012,5723,5806,5723,5795,-402,-763,-289,-1454,72,0,0,8
3049,27/01/2012,5795,5795,5729,5734,-304,-370,-253,-927,-61,1,0,8
3050,30/01/2012,5734,5734,5652,5671,-336,87,-24,-273,-63,1,0,8
3051,31/01/2012,5671,5730,5671,5682,137,173,16,326,11,0,1,8
3052,01/02/2012,5682,5791,5681,5791,326,48,388,762,109,0,1,8
3053,02/02/2012,5791,5810,5766,5796,-139,71,106,38,5,0,1,8
3054,03/02/2012,5796,5901,5784,5901,89,202,93,384,105,0,1,9
3055,06/02/2012,5901,5901,5864,5892,-283,-131,-67,-481,-9,1,0,9
3056,07/02/2012,5892,5907,5850,5890,-69,-24,-148,-241,-2,1,0,9
3057,08/02/2012,5890,5916,5871,5876,-210,-12,-177,-399,-14,1,0,9
3058,09/02/2012,5876,5916,5870,5896,-221,-327,-92,-640,20,0,0,9
3059,10/02/2012,5896,5896,5840,5852,27,-185,-432,-590,-44,1,0,9
3060,13/02/2012,5852,5920,5852,5906,50,54,71,175,54,0,1,9
3061,14/02/2012,5906,5921,5877,5900,302,-325,-43,-66,-6,1,0,9
3062,15/02/2012,5900,5924,5881,5892,144,-113,387,418,-8,0,0,9
3063,16/02/2012,5892,5892,5829,5885,-480,-364,95,-749,-7,1,0,8
3064,17/02/2012,5885,5924,5885,5905,-259,-209,350,-118,20,0,0,8
3065,20/02/2012,5905,5956,5905,5945,21,-180,129,-30,40,0,0,7
3066,21/02/2012,5945,5949,5917,5928,89,-90,-216,-217,-17,1,0,6
3067,22/02/2012,5928,5938,5895,5916,144,142,74,360,-12,0,0,6
3068,23/02/2012,5916,5952,5900,5938,-451,-64,-268,-783,22,0,0,5
3069,24/02/2012,5938,5964,5926,5935,20,84,35,139,-3,0,0,5
3070,27/02/2012,5935,5935,5866,5916,107,-281,-167,-341,-19,1,0,4
3071,28/02/2012,5916,5937,5900,5928,63,-108,104,59,12,0,1,4
3072,29/02/2012,5928,5945,5872,5872,-104,-306,-212,-622,-56,1,0,4
3073,01/03/2012,5872,5936,5859,5931,-61,427,579,945,59,0,1,5
3074,02/03/2012,5931,5940,5908,5911,-70,-192,240,-22,-20,1,0,5
3075,05/03/2012,5911,5911,5865,5875,62,-160,-244,-342,-36,1,0,6
3076,06/03/2012,5875,5875,5758,5766,-338,144,-233,-427,-109,1,0,7
3077,07/03/2012,5766,5801,5756,5791,-161,-71,-90,-322,25,0,0,7
3078,08/03/2012,5791,5874,5791,5860,-13,39,-84,-58,69,0,0,7
3079,09/03/2012,5860,5898,5843,5888,-546,42,15,-489,28,0,0,7
3080,12/03/2012,5888,5894,5860,5893,304,-376,46,-26,5,0,0,7
3081,13/03/2012,5893,5958,5893,5956,-219,-195,195,-219,63,0,0,6
3082,14/03/2012,5956,5989,5945,5945,-177,-51,-10,-238,-11,1,0,5
3083,15/03/2012,5945,5958,5919,5941,-1,76,141,216,-4,0,0,5
3084,16/03/2012,5941,5974,5941,5966,438,45,174,657,25,0,1,4
3085,19/03/2012,5966,5969,5928,5961,-317,283,-11,-45,-5,1,0,4
3086,20/03/2012,5961,5961,5876,5891,85,69,-270,-116,-70,1,0,4
3087,21/03/2012,5891,5922,5881,5892,199,-296,193,96,1,0,1,4
3088,22/03/2012,5892,5892,5826,5846,-242,-101,14,-329,-46,1,0,5
3089,23/03/2012,5846,5876,5802,5855,177,54,156,387,9,0,1,6
3090,26/03/2012,5855,5913,5854,5903,138,-118,97,117,48,0,1,7
3091,27/03/2012,5903,5942,5864,5870,-23,103,277,357,-33,0,0,8
3092,28/03/2012,5870,5878,5809,5809,-148,-75,285,62,-61,0,0,8
3093,29/03/2012,5809,5812,5726,5742,93,-205,-30,-142,-67,1,0,7
3094,30/03/2012,5742,5783,5742,5768,156,-133,143,166,26,0,1,8
3095,02/04/2012,5768,5875,5749,5875,253,-114,234,373,107,0,1,8
3096,03/04/2012,5875,5890,5838,5838,-66,-264,-15,-345,-37,1,0,8
3097,04/04/2012,5838,5838,5686,5704,-5,-518,-97,-620,-134,1,0,8
3098,05/04/2012,5704,5732,5663,5724,45,34,-50,29,20,0,1,8
3099,10/04/2012,5724,5724,5596,5596,-369,-108,-653,-1130,-128,1,0,8
3100,11/04/2012,5596,5656,5576,5635,-91,-411,146,-356,39,0,0,8
3101,12/04/2012,5635,5728,5603,5710,111,-135,-21,-45,75,0,0,7
3102,13/04/2012,5710,5711,5644,5652,200,-225,-239,-264,-58,1,0,7
3103,16/04/2012,5652,5708,5641,5666,-12,-263,-66,-341,14,0,0,8
3104,17/04/2012,5666,5774,5652,5767,-57,-456,-256,-769,101,0,0,7
3105,18/04/2012,5767,5784,5731,5745,647,57,-513,191,-22,0,0,6
3106,19/04/2012,5745,5792,5738,5744,517,80,260,857,-1,0,0,5
3107,20/04/2012,5744,5776,5724,5772,209,134,376,719,28,0,1,4
3108,23/04/2012,5772,5772,5638,5666,53,-155,-346,-448,-106,1,0,4
3109,24/04/2012,5666,5714,5658,5710,62,11,-72,1,44,0,1,4
3110,25/04/2012,5710,5745,5703,5719,-141,22,-195,-314,9,0,0,4
3111,26/04/2012,5719,5761,5692,5749,-73,188,-244,-129,30,0,0,4
3112,27/04/2012,5749,5789,5708,5777,-254,271,236,253,28,0,1,4
3113,30/04/2012,5777,5793,5729,5738,-106,28,50,-28,-39,1,0,4
3114,01/05/2012,5738,5819,5732,5812,-37,92,70,125,74,0,1,5
3115,02/05/2012,5812,5820,5737,5758,-283,48,19,-216,-54,1,0,6
3116,03/05/2012,5758,5801,5745,5766,-181,380,132,331,8,0,1,7
3117,04/05/2012,5766,5766,5640,5655,-284,55,-185,-414,-111,1,0,8
3118,08/05/2012,5655,5668,5550,5554,-72,-51,-66,-189,-101,1,0,8
3119,09/05/2012,5554,5572,5464,5530,71,96,-24,143,-24,0,0,8
3120,10/05/2012,5530,5566,5490,5544,15,-467,-14,-466,14,0,0,7
3121,11/05/2012,5544,5586,5499,5576,190,162,44,396,32,0,1,7
3122,14/05/2012,5576,5576,5437,5466,85,54,-44,95,-110,0,0,8
3123,15/05/2012,5466,5508,5412,5438,44,-143,185,86,-28,0,0,7
3124,16/05/2012,5438,5448,5354,5405,-33,-137,-33,-203,-33,1,0,6
3125,17/05/2012,5405,5413,5310,5338,210,-338,-133,-261,-67,1,0,6
3126,18/05/2012,5338,5338,5257,5268,-256,-489,-256,-1001,-70,1,0,6
3127,21/05/2012,5268,5324,5254,5304,-45,457,-45,367,36,0,1,6
3128,22/05/2012,5304,5409,5304,5403,50,78,255,383,99,0,1,6
3129,23/05/2012,5403,5404,5263,5266,-237,-59,-129,-425,-137,1,0,6
3130,24/05/2012,5266,5372,5266,5350,206,42,-93,155,84,0,1,7
3131,25/05/2012,5350,5385,5312,5352,134,-32,-239,-137,2,0,0,8
3132,28/05/2012,5352,5414,5341,5356,-48,-49,263,166,4,0,1,7
3133,29/05/2012,5356,5405,5342,5391,-30,-743,-118,-891,35,0,0,8
3134,30/05/2012,5391,5391,5284,5297,-311,50,-374,-635,-94,1,0,8
3135,31/05/2012,5297,5352,5273,5321,417,-237,-170,10,24,0,1,8
3136,01/06/2012,5321,5354,5230,5260,-127,-90,-109,-326,-61,1,0,8
3137,06/06/2012,5260,5388,5260,5384,59,42,176,277,124,0,1,8
3138,07/06/2012,5384,5494,5384,5448,826,100,64,990,64,0,1,8
3139,08/06/2012,5448,5448,5382,5435,-51,-13,25,-39,-13,1,0,8
3140,11/06/2012,5435,5536,5420,5432,-24,-102,-71,-197,-3,1,0,8
3141,12/06/2012,5432,5479,5415,5474,-478,261,-84,-301,42,0,0,8
3142,13/06/2012,5474,5508,5437,5484,92,-205,-31,-144,10,0,0,8
3143,14/06/2012,5484,5484,5424,5467,97,-21,-88,-12,-17,1,0,7
3144,15/06/2012,5467,5523,5465,5479,62,316,-96,282,12,0,1,8
3145,18/06/2012,5479,5555,5461,5491,424,-95,-404,-75,12,0,0,8
3146,19/06/2012,5491,5603,5491,5586,73,348,99,520,95,0,1,7
3147,20/06/2012,5586,5624,5566,5622,-332,-44,132,-244,36,0,0,7
3148,21/06/2012,5622,5622,5565,5566,-639,-96,-113,-848,-56,1,0,6
3149,22/06/2012,5566,5566,5500,5514,17,24,-2,39,-52,0,0,6
3150,25/06/2012,5514,5514,5436,5451,111,-522,-186,-597,-63,1,0,5
3151,26/06/2012,5451,5476,5436,5447,-32,-21,1,-52,-4,1,0,5
3152,27/06/2012,5447,5525,5447,5524,171,117,1,289,77,0,1,6
3153,28/06/2012,5524,5534,5436,5493,-135,458,-174,149,-31,0,0,7
3154,29/06/2012,5493,5620,5493,5571,226,-95,77,208,78,0,1,6
3155,02/07/2012,5571,5641,5571,5641,-90,288,150,348,70,0,1,6
3156,03/07/2012,5641,5689,5636,5688,71,102,165,338,47,0,1,7
3157,04/07/2012,5688,5700,5670,5684,-247,-303,-264,-814,-4,1,0,7
3158,05/07/2012,5684,5728,5662,5693,232,-95,-12,125,9,0,1,8
3159,06/07/2012,5693,5695,5648,5663,-202,-405,-405,-1012,-30,1,0,8
3160,09/07/2012,5663,5670,5611,5627,-442,-300,-251,-993,-36,1,0,9
3161,10/07/2012,5627,5689,5622,5664,437,180,-37,580,37,0,1,9
3162,11/07/2012,5664,5675,5626,5664,-191,77,114,0,0,0,0,9
3163,12/07/2012,5664,5664,5589,5608,-185,-71,192,-64,-56,1,0,8
3164,13/07/2012,5608,5676,5608,5666,-147,60,88,1,58,0,1,9
3165,16/07/2012,5666,5671,5641,5662,-98,-280,-136,-514,-4,1,0,9
3166,17/07/2012,5662,5676,5621,5629,-294,-1,-97,-392,-33,1,0,9
3167,18/07/2012,5629,5688,5624,5686,138,-68,-257,-187,57,0,0,9
3168,19/07/2012,5686,5719,5686,5714,343,142,156,641,28,0,1,8
3169,20/07/2012,5714,5714,5645,5652,73,95,-62,106,-62,0,0,8
3170,23/07/2012,5652,5652,5511,5534,-355,25,-129,-459,-118,1,0,7
3171,24/07/2012,5534,5557,5487,5499,19,-74,131,76,-35,0,0,7
3172,25/07/2012,5499,5526,5478,5498,137,-146,-1,-10,-1,1,0,6
3173,26/07/2012,5498,5594,5478,5573,75,-74,83,84,75,0,1,7
3174,27/07/2012,5573,5631,5551,5627,38,531,117,686,54,0,1,7
3175,30/07/2012,5627,5706,5626,5694,111,-365,210,-44,67,0,0,7
3176,31/07/2012,5694,5696,5635,5635,-134,-46,-131,-311,-59,1,0,6
3177,01/08/2012,5635,5713,5633,5713,147,-24,326,449,78,0,1,6
3178,02/08/2012,5713,5766,5657,5662,-51,-185,-123,-359,-51,1,0,7
3179,03/08/2012,5662,5794,5662,5787,123,237,46,406,125,0,1,7
3180,06/08/2012,5787,5838,5767,5809,-314,-43,-43,-400,22,0,0,8
3181,07/08/2012,5809,5841,5785,5841,-14,-203,-59,-276,32,0,0,7
3182,08/08/2012,5841,5846,5801,5846,-35,-28,-17,-80,5,0,0,7
3183,09/08/2012,5846,5860,5828,5852,-428,-4,5,-427,6,0,0,6
3184,10/08/2012,5852,5859,5828,5847,-153,-1,-6,-160,-5,1,0,5
3185,13/08/2012,5847,5853,5814,5832,-326,-37,36,-327,-15,1,0,5
3186,14/08/2012,5832,5876,5832,5865,217,33,176,426,33,0,1,6
3187,15/08/2012,5865,5865,5822,5833,298,-104,-12,182,-32,0,0,6
3188,16/08/2012,5833,5847,5811,5834,-168,-195,-287,-650,1,0,0,5
3189,17/08/2012,5834,5855,5834,5852,277,197,174,648,18,0,1,4
3190,20/08/2012,5852,5858,5803,5824,108,-42,-251,-185,-28,1,0,4
3191,21/08/2012,5824,5873,5824,5858,-170,-197,185,-182,34,0,0,5
3192,22/08/2012,5858,5858,5771,5774,-247,-700,-433,-1380,-84,1,0,5
3193,23/08/2012,5774,5809,5764,5777,-131,143,-4,8,3,0,1,6
3194,24/08/2012,5777,5791,5739,5777,114,458,237,809,0,0,0,7
3195,28/08/2012,5777,5780,5750,5776,85,332,-304,113,-1,0,0,6
3196,29/08/2012,5776,5776,5739,5744,-94,160,-181,-115,-32,1,0,5
3197,30/08/2012,5744,5744,5706,5720,-261,173,-226,-314,-24,1,0,5
3198,31/08/2012,5720,5764,5708,5712,-75,6,193,124,-8,0,0,6
3199,03/09/2012,5712,5758,5701,5758,83,-88,151,146,46,0,1,6
3200,04/09/2012,5758,5758,5658,5672,-562,397,12,-153,-86,1,0,6
3201,05/09/2012,5672,5676,5635,5658,-369,36,138,-195,-14,1,0,6
3202,06/09/2012,5658,5786,5658,5777,36,129,235,400,119,0,1,7
3203,07/09/2012,5777,5808,5773,5795,68,198,-15,251,18,0,1,7
3204,10/09/2012,5795,5807,5777,5793,-2,1,-506,-507,-2,1,0,7
3205,11/09/2012,5793,5797,5764,5792,-154,-276,-589,-1019,-1,1,0,8
3206,12/09/2012,5792,5821,5758,5782,-565,-234,-513,-1312,-10,1,0,9
3207,13/09/2012,5782,5827,5770,5820,617,236,250,1103,38,0,1,9
3208,14/09/2012,5820,5933,5820,5916,20,87,-9,98,96,0,1,9
3209,17/09/2012,5916,5916,5883,5894,-283,21,-5,-267,-22,1,0,10
3210,18/09/2012,5894,5894,5838,5868,-189,17,-116,-288,-26,1,0,10
3211,19/09/2012,5868,5894,5861,5888,438,249,75,762,20,0,1,10
3212,20/09/2012,5888,5888,5824,5855,-295,-191,75,-411,-33,1,0,10
3213,21/09/2012,5855,5888,5839,5853,-36,79,104,147,-2,0,0,10
3214,24/09/2012,5853,5853,5806,5839,-112,-36,-136,-284,-14,1,0,9
3215,25/09/2012,5839,5869,5828,5860,25,146,-110,61,21,0,1,9
3216,26/09/2012,5860,5860,5751,5768,-65,11,-162,-216,-92,1,0,9
3217,27/09/2012,5768,5804,5763,5779,-125,117,146,138,11,0,1,9
3218,28/09/2012,5779,5808,5740,5742,199,-308,68,-41,-37,1,0,9
3219,01/10/2012,5742,5844,5739,5820,403,108,89,600,78,0,1,9
3220,02/10/2012,5820,5840,5781,5810,144,39,10,193,-10,0,0,9
3221,03/10/2012,5810,5832,5785,5826,-88,-300,71,-317,16,0,0,8
3222,04/10/2012,5826,5854,5803,5828,-55,-211,-93,-359,2,0,0,7
3223,05/10/2012,5828,5886,5828,5871,274,43,-339,-22,43,0,0,6
3224,08/10/2012,5871,5871,5819,5842,218,-81,16,153,-29,0,0,6
3225,09/10/2012,5842,5856,5795,5810,-220,-65,-294,-579,-32,1,0,5
3226,10/10/2012,5810,5810,5777,5777,-388,-256,-126,-770,-33,1,0,5
3227,11/10/2012,5777,5846,5767,5830,89,150,57,296,53,0,1,5
3228,12/10/2012,5830,5830,5793,5793,422,101,-451,72,-37,0,0,5
3229,15/10/2012,5793,5828,5786,5806,136,-115,43,64,13,0,1,4
3230,16/10/2012,5806,5878,5806,5870,-212,-48,-33,-293,64,0,0,4
3231,17/10/2012,5870,5916,5869,5911,-159,-26,34,-151,41,0,0,4
3232,18/10/2012,5911,5928,5896,5917,-259,91,6,-162,6,0,0,4
3233,19/10/2012,5917,5920,5892,5896,-304,-181,91,-394,-21,1,0,4
3234,22/10/2012,5896,5911,5870,5883,189,-90,-61,38,-13,0,0,5
3235,23/10/2012,5883,5893,5789,5798,260,95,59,414,-85,0,0,5
3236,24/10/2012,5798,5823,5777,5805,216,-60,42,198,7,0,1,4
3237,25/10/2012,5805,5841,5802,5805,73,328,-41,360,0,0,0,4
3238,26/10/2012,5805,5818,5753,5807,-62,161,80,179,2,0,1,3
3239,29/10/2012,5807,5813,5764,5795,16,522,80,618,-12,0,0,4
3240,30/10/2012,5795,5852,5795,5850,140,75,193,408,55,0,1,3
3241,31/10/2012,5850,5867,5783,5783,-459,-41,-165,-665,-67,1,0,4
3242,01/11/2012,5783,5867,5778,5862,82,-40,109,151,79,0,1,5
3243,02/11/2012,5862,5890,5844,5868,239,95,73,407,6,0,1,6
3244,05/11/2012,5868,5868,5826,5839,-60,314,-2,252,-29,0,0,6
3245,06/11/2012,5839,5885,5839,5885,-238,-407,113,-532,46,0,0,6
3246,07/11/2012,5885,5922,5789,5792,-95,-208,-343,-646,-93,1,0,6
3247,08/11/2012,5792,5824,5771,5776,34,649,-309,374,-16,0,0,6
3248,09/11/2012,5776,5786,5715,5770,-367,120,-256,-503,-6,1,0,6
3249,12/11/2012,5770,5795,5762,5767,10,-3,-256,-249,-3,1,0,6
3250,13/11/2012,5767,5786,5711,5786,200,-3,45,242,19,0,1,7
3251,14/11/2012,5786,5786,5720,5722,131,4,-144,-9,-64,1,0,7
3252,15/11/2012,5722,5722,5674,5678,86,36,199,321,-44,0,0,7
3253,16/11/2012,5678,5683,5606,5606,-266,271,-201,-196,-72,1,0,6
3254,19/11/2012,5606,5740,5606,5738,774,-78,246,942,132,0,1,6
3255,20/11/2012,5738,5752,5707,5748,-152,397,68,313,10,0,1,7
3256,21/11/2012,5748,5760,5728,5752,-124,118,7,1,4,0,1,8
3257,22/11/2012,5752,5796,5752,5791,-3,-50,-121,-174,39,0,0,8
3258,23/11/2012,5791,5830,5781,5819,140,-303,398,235,28,0,1,8
3259,26/11/2012,5819,5819,5774,5787,-88,-97,18,-167,-32,1,0,8
3260,27/11/2012,5787,5823,5787,5800,62,323,158,543,13,0,1,8
3261,28/11/2012,5800,5808,5755,5803,137,-77,466,526,3,0,1,8
3262,29/11/2012,5803,5884,5803,5870,209,85,343,637,67,0,1,8
3263,30/11/2012,5870,5904,5860,5867,-45,67,53,75,-3,0,0,9
3264,03/12/2012,5867,5902,5860,5871,-207,-146,20,-333,4,0,0,8
3265,04/12/2012,5871,5885,5853,5869,-439,-3,289,-153,-2,1,0,7
3266,05/12/2012,5869,5903,5869,5892,826,-29,208,1005,23,0,1,7
3267,06/12/2012,5892,5924,5890,5901,89,142,96,327,9,0,1,7
3268,07/12/2012,5901,5923,5890,5914,83,14,-22,75,13,0,1,8
3269,10/12/2012,5914,5924,5891,5922,86,14,-58,42,8,0,1,8
3270,11/12/2012,5922,5938,5908,5925,10,-225,195,-20,3,0,0,8
3271,12/12/2012,5925,5948,5916,5946,-364,314,314,264,21,0,1,7
3272,13/12/2012,5946,5948,5919,5930,52,139,136,327,-16,0,0,7
3273,14/12/2012,5930,5944,5915,5922,-32,-77,71,-38,-8,1,0,6
3274,17/12/2012,5922,5924,5881,5912,-493,-8,-339,-840,-10,1,0,7
3275,18/12/2012,5912,5946,5911,5936,-91,-100,-279,-470,24,0,0,8
3276,19/12/2012,5936,5978,5936,5962,21,396,331,748,26,0,1,7
3277,20/12/2012,5962,5971,5950,5958,-269,-148,-39,-456,-4,1,0,7
3278,21/12/2012,5958,5958,5894,5940,-10,-77,14,-73,-18,1,0,7
3279,24/12/2012,5940,5958,5937,5954,-211,-830,-492,-1533,14,0,0,7
3280,27/12/2012,5954,5997,5942,5954,364,396,-239,521,0,0,0,6
3281,28/12/2012,5954,5976,5915,5925,-102,-8,269,159,-29,0,0,6
3282,31/12/2012,5925,5925,5873,5898,98,-249,-6,-157,-27,1,0,5
3283,02/01/2013,5898,6045,5898,6027,62,284,370,716,129,0,1,6
3284,03/01/2013,6027,6051,6017,6047,-268,-495,-204,-967,20,0,0,6
3285,04/01/2013,6047,6090,6038,6090,-199,-235,-233,-667,43,0,0,5
3286,07/01/2013,6090,6092,6061,6065,-316,-21,-29,-366,-25,1,0,5
3287,08/01/2013,6065,6088,6054,6054,-364,-471,-94,-929,-11,1,0,5
3288,09/01/2013,6054,6112,6054,6099,421,-102,182,501,45,0,1,5
3289,10/01/2013,6099,6118,6091,6102,-18,-76,-132,-226,3,0,0,5
3290,11/01/2013,6102,6122,6095,6122,-202,-30,-137,-369,20,0,0,5
3291,14/01/2013,6122,6134,6105,6108,-284,286,-15,-13,-14,1,0,5
3292,15/01/2013,6108,6117,6086,6117,355,458,-224,589,9,0,1,6
3293,16/01/2013,6117,6117,6076,6104,260,109,383,752,-13,0,0,6
3294,17/01/2013,6104,6136,6088,6132,70,247,-249,68,28,0,1,5
3295,18/01/2013,6132,6172,6132,6154,-280,131,36,-113,22,0,0,6
3296,21/01/2013,6154,6182,6154,6181,52,53,21,126,27,0,1,6
3297,22/01/2013,6181,6189,6149,6179,-15,-185,-66,-266,-2,1,0,6
3298,23/01/2013,6179,6200,6178,6198,347,-97,-41,209,19,0,1,6
3299,24/01/2013,6198,6271,6186,6265,302,115,83,500,67,0,1,6
3300,25/01/2013,6265,6284,6247,6284,18,5,-102,-79,19,0,0,7
3301,28/01/2013,6284,6311,6277,6294,-162,-375,-367,-904,10,0,0,7
3302,29/01/2013,6294,6346,6286,6339,-210,165,171,126,45,0,1,6
3303,30/01/2013,6339,6354,6316,6323,-289,-95,-73,-457,-16,1,0,6
3304,31/01/2013,6323,6323,6277,6277,-404,-434,-213,-1051,-46,1,0,7
3305,01/02/2013,6277,6354,6276,6347,355,-52,-29,274,70,0,1,7
3306,04/02/2013,6347,6347,6237,6247,-317,-399,-346,-1062,-100,1,0,8
3307,05/02/2013,6247,6296,6244,6283,-106,549,7,450,36,0,1,8
3308,06/02/2013,6283,6322,6266,6295,419,-256,3,166,12,0,1,8
3309,07/02/2013,6295,6313,6217,6228,-91,-108,-279,-478,-67,1,0,8
3310,08/02/2013,6228,6278,6228,6264,171,163,71,405,36,0,1,8
3311,11/02/2013,6264,6295,6252,6277,273,-143,-52,78,13,0,1,9
3312,12/02/2013,6277,6338,6260,6338,29,-168,-255,-394,61,0,0,10
3313,13/02/2013,6338,6385,6312,6359,-103,-130,72,-161,21,0,0,9
3314,14/02/2013,6359,6365,6302,6327,-123,-342,-278,-743,-32,1,0,8
3315,15/02/2013,6327,6352,6310,6328,267,-182,9,94,1,0,1,8
3316,18/02/2013,6328,6330,6307,6318,280,-10,5,275,-10,0,0,8
3317,19/02/2013,6318,6385,6304,6379,364,-708,331,-13,61,0,0,7
3318,20/02/2013,6379,6412,6368,6395,-141,-269,-265,-675,16,0,0,6
3319,21/02/2013,6395,6395,6278,6292,-304,-370,-253,-927,-103,1,0,5
3320,22/02/2013,6292,6347,6292,6336,10,102,263,375,44,0,1,5
3321,25/02/2013,6336,6390,6324,6355,104,157,-352,-91,19,0,0,5
3322,26/02/2013,6355,6355,6259,6270,108,-364,52,-204,-85,1,0,4
3323,27/02/2013,6270,6336,6269,6326,204,-10,225,419,56,0,1,5
3324,28/02/2013,6326,6372,6326,6361,51,160,-242,-31,35,0,0,6
3325,01/03/2013,6361,6392,6309,6379,121,-90,239,270,18,0,1,5
3326,04/03/2013,6379,6379,6333,6346,-152,-222,-50,-424,-33,1,0,5
3327,05/03/2013,6346,6437,6345,6432,-476,110,-456,-822,86,0,0,6
3328,06/03/2013,6432,6461,6419,6428,-179,-370,-308,-857,-4,1,0,6
3329,07/03/2013,6428,6460,6427,6439,-433,-171,-304,-908,11,0,0,7
3330,08/03/2013,6439,6490,6439,6484,-377,-464,-315,-1156,45,0,0,6
3331,11/03/2013,6484,6505,6474,6504,-136,-402,-132,-670,20,0,0,5
3332,12/03/2013,6504,6534,6492,6511,63,54,-111,6,7,0,1,5
3333,13/03/2013,6511,6511,6438,6482,134,192,-17,309,-29,0,0,5
3334,14/03/2013,6482,6533,6478,6529,391,-111,145,425,47,0,1,4
3335,15/03/2013,6529,6534,6470,6490,-202,-9,-138,-349,-39,1,0,5
3336,18/03/2013,6490,6490,6386,6458,-32,94,-1,61,-32,0,0,5
3337,19/03/2013,6458,6475,6414,6441,199,73,-87,185,-17,0,0,4
3338,20/03/2013,6441,6476,6421,6433,452,24,-207,269,-8,0,0,4
3339,21/03/2013,6433,6436,6364,6388,63,16,-390,-311,-45,1,0,3
3340,22/03/2013,6388,6426,6374,6393,-95,127,98,130,5,0,1,4
3341,25/03/2013,6393,6458,6367,6378,-185,226,-91,-50,-15,1,0,5
3342,26/03/2013,6378,6404,6370,6399,-96,76,-77,-97,21,0,0,6
3343,27/03/2013,6399,6421,6344,6388,107,704,-298,513,-11,0,0,5
3344,28/03/2013,6388,6448,6382,6412,-15,694,28,707,24,0,1,5
3345,02/04/2013,6412,6502,6409,6491,-9,39,268,298,79,0,1,5
3346,03/04/2013,6491,6492,6417,6420,-99,-62,-139,-300,-71,1,0,5
3347,04/04/2013,6420,6426,6341,6344,-288,-395,-99,-782,-76,1,0,6
3348,05/04/2013,6344,6347,6214,6250,-138,-83,98,-123,-94,1,0,7
3349,08/04/2013,6250,6290,6250,6277,-67,136,-126,-57,27,0,0,8
3350,09/04/2013,6277,6326,6277,6313,48,404,141,593,36,0,1,7
3351,10/04/2013,6313,6405,6313,6387,122,-42,356,436,74,0,1,7
3352,11/04/2013,6387,6424,6378,6416,-98,-50,-225,-373,29,0,0,7
3353,12/04/2013,6416,6416,6368,6384,-13,33,175,195,-32,0,0,7
3354,15/04/2013,6384,6384,6300,6344,236,-116,37,157,-40,0,0,7
3355,16/04/2013,6344,6344,6298,6305,-177,-492,-134,-803,-39,1,0,6
3356,17/04/2013,6305,6334,6225,6244,-338,-59,-61,-458,-61,1,0,6
3357,18/04/2013,6244,6278,6226,6244,-187,-19,-289,-495,0,0,0,6
3358,19/04/2013,6244,6289,6244,6287,50,156,-28,178,43,0,1,5
3359,22/04/2013,6287,6342,6259,6281,-35,-183,221,3,-6,0,0,5
3360,23/04/2013,6281,6406,6278,6406,120,-232,401,289,125,0,1,5
3361,24/04/2013,6406,6439,6396,6432,11,-102,169,78,26,0,1,5
3362,25/04/2013,6432,6467,6412,6443,-34,-129,-42,-205,11,0,0,5
3363,26/04/2013,6443,6443,6399,6426,-51,-8,-34,-93,-17,1,0,5
3364,29/04/2013,6426,6458,6419,6458,-84,-48,317,185,32,0,1,6
3365,30/04/2013,6458,6483,6413,6430,22,3,-34,-9,-28,1,0,7
3366,01/05/2013,6430,6476,6430,6451,-124,-217,33,-308,21,0,0,7
3367,02/05/2013,6451,6470,6410,6461,391,-107,-66,218,10,0,1,6
3368,03/05/2013,6461,6542,6452,6522,83,-44,126,165,61,0,1,7
3369,07/05/2013,6522,6564,6521,6557,97,-242,53,-92,35,0,0,7
3370,08/05/2013,6557,6587,6547,6584,40,5,5,50,27,0,1,7
3371,09/05/2013,6584,6597,6572,6593,-61,33,137,109,9,0,1,7
3372,10/05/2013,6593,6638,6592,6625,-111,122,2,13,32,0,1,7
3373,13/05/2013,6625,6633,6603,6632,-316,-44,-57,-417,7,0,0,8
3374,14/05/2013,6632,6686,6618,6686,-111,191,25,105,54,0,1,7
3375,15/05/2013,6686,6702,6669,6694,-632,30,2,-600,8,0,0,7
3376,16/05/2013,6694,6714,6677,6688,-316,-572,-602,-1490,-6,1,0,6
3377,17/05/2013,6688,6727,6670,6723,-554,-253,-268,-1075,35,0,0,7
3378,20/05/2013,6723,6756,6709,6756,313,-526,-55,-268,33,0,0,6
3379,21/05/2013,6756,6804,6744,6804,-136,163,165,192,48,0,1,5
3380,22/05/2013,6804,6876,6782,6840,-289,-95,-73,-457,36,0,0,6
3381,23/05/2013,6840,6840,6659,6697,-247,-303,-264,-814,-143,1,0,5
3382,24/05/2013,6697,6720,6640,6654,-191,-172,-341,-704,-43,1,0,5
3383,28/05/2013,6654,6791,6654,6762,114,127,157,398,108,0,1,5
3384,29/05/2013,6762,6762,6621,6627,62,-70,149,141,-135,0,0,6
3385,30/05/2013,6627,6657,6611,6657,147,398,4,549,30,0,1,5
3386,31/05/2013,6657,6657,6578,6583,197,163,275,635,-74,0,0,6
3387,03/06/2013,6583,6583,6514,6525,183,-121,-136,-74,-58,1,0,5
3388,04/06/2013,6525,6577,6525,6559,191,34,94,319,34,0,1,6
3389,05/06/2013,6559,6559,6419,6419,-117,113,6,2,-140,0,0,7
3390,06/06/2013,6419,6435,6336,6336,-97,428,-83,248,-83,0,0,6
3391,07/06/2013,6336,6421,6314,6412,76,117,76,269,76,0,1,6
3392,10/06/2013,6412,6421,6380,6400,-102,-4,54,-52,-12,1,0,6
3393,11/06/2013,6400,6401,6280,6340,-70,-157,-119,-346,-60,1,0,6
3394,12/06/2013,6340,6364,6296,6300,50,-40,54,64,-40,0,0,6
3395,13/06/2013,6300,6311,6206,6305,113,219,113,445,5,0,1,6
3396,14/06/2013,6305,6344,6291,6308,-225,78,-57,-204,3,0,0,6
3397,17/06/2013,6308,6371,6308,6330,-43,51,106,114,22,0,1,6
3398,18/06/2013,6330,6397,6311,6374,367,269,-3,633,44,0,1,6
3399,19/06/2013,6374,6384,6327,6349,-43,-84,-386,-513,-25,1,0,6
3400,20/06/2013,6349,6349,6145,6160,-317,-139,-60,-516,-189,1,0,7
3401,21/06/2013,6160,6244,6116,6116,-22,-285,50,-257,-44,1,0,8
3402,24/06/2013,6116,6136,6023,6029,-90,-110,-90,-290,-87,1,0,8
3403,25/06/2013,6029,6115,6029,6102,-51,-360,-239,-650,73,0,0,8
3404,26/06/2013,6102,6178,6089,6166,-159,-46,-161,-366,64,0,0,7
3405,27/06/2013,6166,6272,6166,6243,158,-139,-28,-9,77,0,0,7
3406,28/06/2013,6243,6269,6208,6216,-64,71,80,87,-27,0,0,6
3407,01/07/2013,6216,6317,6215,6308,-34,-168,-483,-685,92,0,0,6
3408,02/07/2013,6308,6314,6266,6304,90,56,66,212,-4,0,0,5
3409,03/07/2013,6304,6304,6185,6230,85,-324,23,-216,-74,1,0,4
3410,04/07/2013,6230,6431,6230,6422,538,114,11,663,192,0,1,4
3411,05/07/2013,6422,6499,6364,6376,-152,-78,-78,-308,-46,1,0,4
3412,08/07/2013,6376,6476,6376,6450,160,11,3,174,74,0,1,4
3413,09/07/2013,6450,6531,6450,6513,-367,-149,117,-399,63,0,0,4
3414,10/07/2013,6513,6536,6472,6505,209,-8,-8,193,-8,0,0,4
3415,11/07/2013,6505,6586,6505,6543,40,39,38,117,38,0,1,4
3416,12/07/2013,6543,6584,6540,6545,34,-4,-53,-23,2,0,0,5
3417,15/07/2013,6545,6606,6545,6586,-249,55,149,-45,41,0,0,5
3418,16/07/2013,6586,6606,6556,6556,-294,-15,-30,-339,-30,1,0,5
3419,17/07/2013,6556,6596,6517,6572,-493,122,-432,-803,16,0,0,6
3420,18/07/2013,6572,6657,6556,6634,391,-56,19,354,62,0,1,5
3421,19/07/2013,6634,6635,6592,6631,-3,-416,-294,-713,-3,1,0,5
3422,22/07/2013,6631,6645,6608,6623,-442,-300,-251,-993,-8,1,0,5
3423,23/07/2013,6623,6658,6597,6597,386,-405,123,104,-26,0,0,5
3424,24/07/2013,6597,6662,6582,6620,207,50,-124,133,23,0,1,5
3425,25/07/2013,6620,6625,6540,6588,-121,-11,-122,-254,-32,1,0,6
3426,26/07/2013,6588,6630,6535,6555,51,-217,-20,-186,-33,1,0,6
3427,29/07/2013,6555,6606,6544,6560,49,686,36,771,5,0,1,7
3428,30/07/2013,6560,6601,6560,6571,-182,38,32,-112,11,0,0,8
3429,31/07/2013,6571,6659,6557,6621,164,535,77,776,50,0,1,7
3430,01/08/2013,6621,6682,6607,6682,223,151,-82,292,61,0,1,8
3431,02/08/2013,6682,6697,6624,6648,-259,-300,-91,-650,-34,1,0,8
3432,05/08/2013,6648,6685,6590,6620,490,-374,-199,-83,-28,1,0,8
3433,06/08/2013,6620,6630,6562,6604,-451,89,-295,-657,-16,1,0,8
3434,07/08/2013,6604,6625,6511,6511,-257,-413,-181,-851,-93,1,0,9
3435,08/08/2013,6511,6559,6507,6530,25,322,-28,319,19,0,1,9
3436,09/08/2013,6530,6601,6530,6583,138,164,1,303,53,0,1,9
3437,12/08/2013,6583,6598,6547,6574,41,181,70,292,-9,0,0,9
3438,13/08/2013,6574,6620,6568,6612,106,-295,38,-151,38,0,0,8
3439,14/08/2013,6612,6628,6583,6587,-173,-5,132,-46,-25,1,0,8
3440,15/08/2013,6587,6588,6460,6483,58,-377,70,-249,-104,1,0,8
3441,16/08/2013,6483,6502,6461,6500,361,-103,-2,256,17,0,1,8
3442,19/08/2013,6500,6507,6458,6466,164,164,99,427,-34,0,0,8
3443,20/08/2013,6466,6466,6399,6454,-166,129,-132,-169,-12,1,0,7
3444,21/08/2013,6454,6454,6387,6391,-3,262,-105,154,-63,0,0,7
3445,22/08/2013,6391,6469,6391,6447,25,-59,160,126,56,0,1,6
3446,23/08/2013,6447,6517,6422,6492,92,127,286,505,45,0,1,6
3447,27/08/2013,6492,6494,6424,6441,-56,117,111,172,-51,0,0,6
3448,02/09/2013,6413,6532,6413,6506,258,305,50,613,93,0,1,6
3449,03/09/2013,6506,6523,6457,6468,-230,29,-245,-446,-38,1,0,7
3450,04/09/2013,6468,6486,6424,6475,-141,-164,39,-266,7,0,0,7
3451,05/09/2013,6475,6543,6462,6532,-145,52,-120,-213,57,0,0,6
3452,06/09/2013,6532,6568,6492,6547,-124,212,190,278,15,0,1,5
3453,09/09/2013,6547,6556,6509,6531,-34,-143,-86,-263,-16,1,0,6
3454,10/09/2013,6531,6600,6531,6584,229,445,178,852,53,0,1,6
3455,11/09/2013,6584,6590,6560,6588,122,-15,38,145,4,0,1,7
3456,12/09/2013,6588,6606,6559,6589,34,-234,-147,-347,1,0,0,7
3457,13/09/2013,6589,6589,6562,6584,-179,24,-199,-354,-5,1,0,6
3458,16/09/2013,6584,6653,6584,6623,-163,60,302,199,39,0,1,7
3459,17/09/2013,6623,6623,6570,6570,-546,-170,90,-626,-53,1,0,7
3460,18/09/2013,6570,6588,6532,6559,-327,31,-168,-464,-11,1,0,7
3461,19/09/2013,6559,6659,6559,6625,396,96,114,606,66,0,1,8
3462,20/09/2013,6625,6630,6594,6596,-31,280,269,518,-29,0,0,9
3463,23/09/2013,6596,6602,6543,6557,-442,-98,-437,-977,-39,1,0,8
3464,24/09/2013,6557,6585,6550,6572,-97,508,-6,405,15,0,1,8
3465,25/09/2013,6572,6588,6526,6552,-185,-249,-300,-734,-20,1,0,8
3466,26/09/2013,6552,6581,6536,6566,17,-47,86,56,14,0,1,8
3467,27/09/2013,6566,6569,6487,6513,98,-64,41,75,-53,0,0,9
3468,30/09/2013,6513,6513,6439,6462,-93,174,7,88,-51,0,0,8
3469,01/10/2013,6462,6466,6424,6460,85,-100,-42,-57,-2,1,0,7
3470,02/10/2013,6460,6460,6386,6438,13,36,209,258,-22,0,0,7
3471,03/10/2013,6438,6472,6436,6449,405,-162,-92,151,11,0,1,6
3472,04/10/2013,6449,6474,6429,6454,-361,126,2,-233,5,0,0,6
3473,07/10/2013,6454,6454,6392,6437,-69,-265,-237,-571,-17,1,0,6
3474,08/10/2013,6437,6438,6365,6366,-254,-2,5,-251,-71,1,0,6
3475,09/10/2013,6366,6373,6317,6338,-27,143,12,128,-28,0,0,6
3476,10/10/2013,6338,6446,6338,6430,-112,271,-34,125,92,0,1,5
3477,11/10/2013,6430,6489,6430,6487,70,449,-113,406,57,0,1,5
3478,14/10/2013,6487,6508,6464,6508,317,1,-178,140,21,0,1,6
3479,15/10/2013,6508,6569,6508,6549,53,34,43,130,41,0,1,7
3480,16/10/2013,6549,6584,6504,6572,73,-67,-6,0,23,0,0,7
3481,17/10/2013,6572,6576,6529,6576,-13,24,4,15,4,0,1,7
3482,18/10/2013,6576,6623,6576,6623,8,-295,-2,-289,47,0,0,7
3483,21/10/2013,6623,6654,6618,6654,-410,-145,-50,-605,31,0,0,7
3484,22/10/2013,6654,6719,6654,6696,-111,5,112,6,42,0,1,6
3485,23/10/2013,6696,6696,6655,6674,124,-28,-17,79,-22,0,0,6
3486,24/10/2013,6674,6719,6674,6713,-191,149,67,25,39,0,1,6
3487,25/10/2013,6713,6730,6700,6721,-61,132,45,116,8,0,1,6
3488,28/10/2013,6721,6740,6704,6726,170,-22,11,159,5,0,1,6
3489,29/10/2013,6726,6777,6719,6775,-202,117,6,-79,49,0,0,6
3490,30/10/2013,6775,6820,6764,6778,-136,122,48,34,3,0,1,5
3491,31/10/2013,6778,6778,6720,6731,-4,-314,-432,-750,-47,1,0,6
3492,01/11/2013,6731,6761,6715,6735,-173,370,-159,38,4,0,1,6
3493,04/11/2013,6735,6780,6735,6764,-402,56,-296,-642,29,0,0,7
3494,05/11/2013,6764,6774,6708,6747,120,171,161,452,-17,0,0,7
3495,06/11/2013,6747,6768,6736,6742,67,-745,-121,-799,-5,1,0,6
3496,07/11/2013,6742,6779,6680,6697,96,-100,204,200,-45,0,0,7
3497,08/11/2013,6697,6714,6644,6708,62,427,15,504,11,0,1,6
3498,11/11/2013,6708,6745,6702,6728,-172,372,511,711,20,0,1,6
3499,12/11/2013,6728,6728,6693,6727,-227,43,-183,-367,-1,1,0,6
3500,13/11/2013,6727,6727,6614,6630,97,-127,-225,-255,-97,1,0,7
3501,14/11/2013,6630,6696,6630,6666,381,260,144,785,36,0,1,7
3502,15/11/2013,6666,6703,6666,6693,-69,286,116,333,27,0,1,7
3503,18/11/2013,6693,6732,6672,6724,-8,-470,239,-239,31,0,0,7
3504,19/11/2013,6724,6724,6678,6698,18,-50,-327,-359,-26,1,0,7
3505,20/11/2013,6698,6711,6662,6681,42,-184,3,-139,-17,1,0,8
3506,21/11/2013,6681,6698,6644,6681,37,-270,-33,-266,0,0,0,8
3507,22/11/2013,6681,6711,6661,6674,203,-431,-104,-332,-7,1,0,8
3508,25/11/2013,6674,6709,6674,6695,193,157,-105,245,21,0,1,8
3509,26/11/2013,6695,6697,6636,6636,-30,-153,-265,-448,-59,1,0,8
3510,27/11/2013,6636,6664,6636,6650,-285,-73,30,-328,14,0,0,8
3511,28/11/2013,6650,6680,6643,6654,8,-182,43,-131,4,0,0,7
3512,29/11/2013,6654,6682,6648,6651,181,-159,-386,-364,-3,1,0,6
3513,02/12/2013,6651,6657,6595,6595,-187,41,-376,-522,-56,1,0,6
3514,03/12/2013,6595,6596,6531,6532,58,55,108,221,-63,0,0,7
3515,04/12/2013,6532,6545,6480,6510,-177,69,-202,-310,-22,1,0,6
3516,05/12/2013,6510,6519,6487,6498,-317,46,-97,-368,-12,1,0,6
3517,06/12/2013,6498,6556,6496,6552,171,75,54,300,54,0,1,7
3518,09/12/2013,6552,6568,6535,6560,-102,-380,39,-443,8,0,0,7
3519,10/12/2013,6560,6572,6519,6523,-5,-59,-33,-97,-37,1,0,6
3520,11/12/2013,6523,6556,6508,6508,144,252,163,559,-15,0,0,6
3521,12/12/2013,6508,6508,6436,6445,119,-456,42,-295,-63,1,0,6
3522,13/12/2013,6445,6463,6434,6440,121,-103,-31,-13,-5,1,0,7
3523,16/12/2013,6440,6531,6422,6522,284,262,213,759,82,0,1,7
3524,17/12/2013,6522,6522,6483,6486,-73,-10,3,-80,-36,1,0,7
3525,18/12/2013,6486,6524,6486,6492,-189,42,-100,-247,6,0,0,8
3526,19/12/2013,6492,6566,6492,6555,214,-44,106,276,63,0,1,7
3527,20/12/2013,6585,6617,6577,6607,4,32,175,211,22,0,1,7
3528,23/12/2013,6607,6679,6606,6679,142,-266,-18,-142,72,0,0,7
3529,24/12/2013,6679,6712,6672,6694,49,51,15,115,15,0,1,7
3530,27/12/2013,6694,6754,6694,6751,195,165,102,462,57,0,1,7
3531,30/12/2013,6751,6768,6718,6731,67,-92,-135,-160,-20,1,0,8
3532,31/12/2013,6731,6757,6731,6749,169,11,3,183,18,0,1,8
3533,02/01/2014,6749,6759,6708,6718,21,-28,-160,-167,-31,1,0,8
3534,03/01/2014,6718,6747,6699,6731,-221,-234,-157,-612,13,0,0,8
3535,06/01/2014,6731,6752,6715,6731,-192,39,-225,-378,0,0,0,7
3536,07/01/2014,6731,6769,6718,6756,92,-95,216,213,25,0,1,7
3537,08/01/2014,6756,6756,6713,6722,-324,355,8,39,-34,0,0,7
3538,09/01/2014,6722,6746,6679,6691,-326,-78,50,-354,-31,1,0,6
3539,13/01/2014,6740,6766,6731,6757,-135,53,146,64,17,0,1,7
3540,14/01/2014,6757,6773,6694,6767,12,-32,72,52,10,0,1,7
3541,15/01/2014,6767,6825,6767,6820,-180,118,-76,-138,53,0,0,7
3542,16/01/2014,6820,6832,6811,6815,-202,-171,91,-282,-5,1,0,6
3543,17/01/2014,6815,6840,6800,6829,85,-65,106,126,14,0,1,6
3544,20/01/2014,6829,6838,6811,6837,-123,-117,102,-138,8,0,0,6
3545,21/01/2014,6837,6867,6822,6834,-247,-236,-269,-752,-3,1,0,6
3546,22/01/2014,6834,6865,6822,6826,189,-286,-527,-624,-8,1,0,7
3547,23/01/2014,6826,6837,6761,6773,144,-189,-91,-136,-53,1,0,7
3548,24/01/2014,6773,6784,6655,6664,-408,-263,-404,-1075,-109,1,0,8
3549,27/01/2014,6664,6665,6539,6551,-193,-156,-113,-462,-113,1,0,8
3550,28/01/2014,6551,6591,6551,6572,21,764,21,806,21,0,1,8
3551,29/01/2014,6572,6645,6483,6544,-50,297,-14,233,-28,0,0,8
3552,30/01/2014,6544,6574,6503,6538,83,-524,5,-436,-6,1,0,8
3553,31/01/2014,6538,6548,6421,6510,-231,-111,-231,-573,-28,1,0,8
3554,03/02/2014,6510,6538,6460,6466,-87,-123,4,-206,-44,1,0,8
3555,04/02/2014,6466,6478,6417,6449,210,-358,-133,-281,-17,1,0,9
3556,05/02/2014,6449,6484,6424,6458,-102,162,-90,-30,9,0,0,9
3557,06/02/2014,6458,6566,6458,6558,-29,-89,76,-42,100,0,0,8
3558,07/02/2014,6558,6596,6541,6572,16,-272,118,-138,14,0,0,7
3559,10/02/2014,6572,6597,6565,6592,84,74,339,497,20,0,1,6
3560,11/02/2014,6592,6673,6592,6673,-30,233,143,346,81,0,1,6
3561,12/02/2014,6673,6708,6669,6675,37,-77,-10,-50,2,0,0,6
3562,13/02/2014,6675,6675,6608,6659,192,34,73,299,-16,0,0,6
3563,14/02/2014,6659,6672,6646,6664,-142,-90,17,-215,5,0,0,5
3564,17/02/2014,6664,6746,6662,6736,234,348,164,746,72,0,1,4
3565,18/02/2014,6736,6803,6717,6796,402,11,-17,396,60,0,1,4
3566,19/02/2014,6796,6810,6760,6797,49,-16,1,34,1,0,1,4
3567,20/02/2014,6797,6813,6732,6813,437,258,-17,678,16,0,1,5
3568,21/02/2014,6813,6860,6813,6838,-279,117,-97,-259,25,0,0,6
3569,24/02/2014,6838,6866,6798,6866,-316,33,8,-275,28,0,0,6
3570,25/02/2014,6863,6866,6791,6830,-316,-160,-13,-489,-33,1,0,5
3571,26/02/2014,6830,6834,6785,6799,-1,53,-66,-14,-31,1,0,5
3572,27/02/2014,6799,6819,6734,6810,3,376,-298,81,11,0,1,6
3573,28/02/2014,6810,6834,6786,6810,300,56,-321,35,0,0,0,7
3574,03/03/2014,6810,6810,6672,6708,-328,7,118,-203,-102,1,0,7
3575,04/03/2014,6708,6827,6708,6824,62,373,300,735,116,0,1,7
3576,05/03/2014,6824,6824,6772,6775,41,89,-433,-303,-49,1,0,7
3577,06/03/2014,6775,6807,6771,6788,-172,372,511,711,13,0,1,7
3578,07/03/2014,6788,6801,6706,6713,133,-470,-58,-395,-75,1,0,7
3579,10/03/2014,6713,6757,6672,6690,326,164,-42,448,-23,0,0,8
3580,11/03/2014,6690,6718,6661,6686,353,322,166,841,-4,0,0,8
3581,12/03/2014,6686,6686,6598,6621,-75,196,68,189,-65,0,0,7
3582,13/03/2014,6621,6631,6552,6554,-119,99,-59,-79,-67,1,0,6
3583,14/03/2014,6554,6554,6500,6528,14,-396,-35,-417,-26,1,0,6
3584,17/03/2014,6528,6592,6528,6568,-157,-104,45,-216,40,0,0,7
3585,18/03/2014,6568,6628,6535,6605,-141,124,-49,-66,37,0,0,6
3586,19/03/2014,6605,6610,6567,6573,3,-265,62,-200,-32,1,0,5
3587,20/03/2014,6573,6573,6493,6542,70,-226,346,190,-31,0,0,5
3588,21/03/2014,6542,6572,6538,6557,4,-77,212,139,15,0,1,4
3589,24/03/2014,6557,6569,6506,6520,1,-237,114,-122,-37,1,0,4
3590,25/03/2014,6520,6605,6520,6605,99,-58,123,164,85,0,1,5
3591,26/03/2014,6605,6644,6602,6605,677,198,64,939,0,0,0,6
3592,27/03/2014,6605,6605,6561,6588,89,134,260,483,-17,0,0,6
3593,28/03/2014,6588,6632,6586,6616,-98,-50,-225,-373,28,0,0,5
3594,31/03/2014,6616,6658,6583,6598,-62,201,109,248,-18,0,0,4
3595,01/04/2014,6598,6660,6598,6653,233,-109,-27,97,55,0,1,4
3596,02/04/2014,6653,6673,6640,6659,-216,-18,-42,-276,6,0,0,5
3597,03/04/2014,6659,6681,6638,6649,-369,212,33,-124,-10,1,0,4
3598,04/04/2014,6649,6706,6649,6696,520,55,-66,509,47,0,1,5
3599,07/04/2014,6696,6696,6615,6623,232,-180,66,118,-73,0,0,5
3600,08/04/2014,6623,6625,6550,6591,-311,68,-242,-485,-32,1,0,4
3601,09/04/2014,6591,6654,6590,6636,-135,43,180,88,45,0,1,4
3602,10/04/2014,6636,6688,6620,6642,46,-36,-174,-164,6,0,0,5
3603,11/04/2014,6642,6642,6539,6562,-187,-280,-45,-512,-80,1,0,5
3604,14/04/2014,6562,6584,6507,6584,82,-118,267,231,22,0,1,6
3605,15/04/2014,6584,6594,6534,6542,48,59,246,353,-42,0,0,7
3606,16/04/2014,6542,6597,6542,6584,-46,-274,266,-54,42,0,0,6
3607,17/04/2014,6584,6627,6559,6625,138,-142,119,115,41,0,1,6
3608,22/04/2014,6625,6706,6625,6682,-91,-407,193,-305,57,0,0,6
3609,23/04/2014,6682,6695,6661,6675,191,-75,20,136,-7,0,0,5
3610,24/04/2014,6675,6725,6668,6703,78,-35,95,138,28,0,1,5
3611,25/04/2014,6703,6704,6657,6686,-284,-97,-9,-390,-17,1,0,5
3612,28/04/2014,6686,6720,6683,6700,-117,243,174,300,14,0,1,5
3613,29/04/2014,6700,6770,6700,6770,513,296,228,1037,70,0,1,6
3614,30/04/2014,6770,6795,6749,6780,-279,185,115,21,10,0,1,6
3615,01/05/2014,6780,6812,6774,6809,-153,58,-72,-167,29,0,0,6
3616,02/05/2014,6809,6838,6799,6822,-61,-121,131,-51,13,0,0,6
3617,05/05/2014,6809,6838,6799,6822,44,-237,-21,-214,13,0,0,6
3618,06/05/2014,6822,6829,6785,6799,-259,-37,-188,-484,-23,1,0,5
3619,07/05/2014,6799,6799,6767,6796,490,-8,54,536,-3,0,0,6
3620,08/05/2014,6796,6840,6796,6839,252,299,45,596,43,0,1,6
3621,09/05/2014,6839,6839,6805,6814,86,14,-58,42,-25,0,0,6
3622,12/05/2014,6814,6851,6814,6851,-245,376,-164,-33,37,0,0,5
3623,13/05/2014,6851,6877,6845,6873,-324,299,169,144,22,0,1,4
3624,14/05/2014,6873,6880,6854,6878,83,140,91,314,5,0,1,4
3625,15/05/2014,6878,6894,6821,6840,52,185,-269,-32,-38,1,0,4
3626,16/05/2014,6841,6856,6814,6856,-306,-416,-93,-815,15,0,0,5
3627,19/05/2014,6856,6862,6804,6845,3,128,-242,-111,-11,1,0,5
3628,20/05/2014,6844,6848,6792,6802,-2,-395,-411,-808,-42,1,0,6
3629,21/05/2014,6802,6821,6782,6821,-1,320,-27,292,19,0,1,6
3630,22/05/2014,6821,6846,6810,6820,222,-211,-102,-91,-1,1,0,7
3631,23/05/2014,6821,6826,6794,6816,275,412,139,826,-5,0,0,7
3632,27/05/2014,6815,6857,6815,6844,-33,-38,99,28,29,0,1,7
3633,28/05/2014,6844,6855,6833,6851,-252,-143,33,-362,7,0,0,8
3634,29/05/2014,6851,6882,6848,6871,-179,89,-17,-107,20,0,0,7
3635,30/05/2014,6871,6874,6831,6844,239,-120,174,293,-27,0,0,6
3636,02/06/2014,6844,6874,6844,6864,114,483,33,630,20,0,1,5
3637,03/06/2014,6864,6865,6817,6836,48,-129,117,36,-28,0,0,6
3638,04/06/2014,6836,6840,6800,6818,-136,9,13,-114,-18,1,0,5
3639,05/06/2014,6818,6847,6795,6813,-202,412,-43,167,-5,0,0,5
3640,06/06/2014,6813,6862,6813,6858,264,214,-72,406,45,0,1,4
