"","Date","Open","High","Low","Close","a1","a2","a3","a4","pl"
"2000","16/11/2007",6594,6594,6517,6526,-97,-139,79,-157,-68
"2001","19/11/2007",6538,6615,6538,6601,88,63,100,251,63
"2002","20/11/2007",6563,6563,6462,6490,3,-293,-42,-332,-73
"2003","21/11/2007",6502,6503,6425,6450,-49,-18,69,2,-52
"2004","22/11/2007",6425,6425,6373,6395,-41,-121,-89,-251,-30
"2005","23/11/2007",6398,6406,6375,6392,5,-119,-21,-135,-6
"2006","26/11/2007",6420,6543,6420,6533,-85,-39,86,-38,113
"2007","27/11/2007",6503,6503,6417,6494,-73,-37,-26,-136,-9
"2008","28/11/2007",6492,6495,6413,6433,1,111,-48,64,-59
"2009","29/11/2007",6459,6541,6459,6507,-56,-2,-178,-236,48
"2010","30/11/2007",6519,6608,6501,6594,357,292,137,786,75
"2011","03/12/2007",6595,6625,6587,6597,115,-25,84,174,2
"2012","04/12/2007",6583,6594,6560,6589,32,138,124,294,6
"2013","05/12/2007",6580,6580,6543,6568,-218,-131,36,-313,-12
"2014","06/12/2007",6591,6673,6591,6660,-9,-83,38,-54,69
"2015","07/12/2007",6671,6728,6670,6714,-32,91,161,220,43
"2016","10/12/2007",6718,6718,6674,6686,-80,-19,-88,-187,-32
"2017","11/12/2007",6694,6741,6694,6738,54,70,70,194,44
"2018","12/12/2007",6714,6714,6642,6675,-131,-42,-69,-242,-39
"2019","13/12/2007",6682,6704,6627,6661,115,105,-94,126,-21
"2020","14/12/2007",6652,6656,6534,6556,124,-116,-220,-212,-96
"2021","17/12/2007",6537,6538,6332,6332,-236,-168,-268,-672,-205
"2022","18/12/2007",6314,6314,6168,6293,-21,-153,-21,-195,-21
"2023","19/12/2007",6312,6327,6258,6281,-31,25,-31,-37,-31
"2024","20/12/2007",6289,6301,6245,6245,-44,255,-113,98,-44
"2025","21/12/2007",6251,6345,6250,6309,-11,282,58,329,58
"2026","24/12/2007",6331,6402,6331,6388,32,42,59,133,57
"2027","27/12/2007",6402,6434,6401,6426,205,38,-30,213,24
"2028","28/12/2007",6411,6424,6373,6424,188,-71,-195,-78,13
"2029","31/12/2007",6426,6431,6397,6421,-84,207,112,235,-5
"2030","02/01/2008",6419,6463,6408,6434,23,8,-4,27,15
"2031","03/01/2008",6423,6423,6336,6373,-127,14,-49,-162,-50
"2032","04/01/2008",6388,6421,6355,6385,-192,17,-105,-280,-3
"2033","07/01/2008",6358,6358,6228,6240,-135,-17,-212,-364,-118
"2034","08/01/2008",6233,6260,6195,6206,27,-87,84,24,-27
"2035","09/01/2008",6193,6193,6111,6160,-33,-606,-42,-681,-33
"2036","10/01/2008",6160,6176,6121,6147,-13,-145,-13,-171,-13
"2037","11/01/2008",6155,6164,6054,6054,-137,-42,-137,-316,-101
"2038","14/01/2008",6041,6073,5971,6041,222,237,222,681,0
"2039","15/01/2008",6042,6102,6006,6020,-11,52,-11,30,-22
"2040","16/01/2008",6004,6020,5848,5871,-128,-145,-128,-401,-133
"2041","17/01/2008",5878,5904,5848,5857,309,255,309,873,-21
"2042","18/01/2008",5803,5811,5681,5799,-4,241,-4,233,-4
"2043","21/01/2008",5789,5790,5631,5631,-158,241,-158,-75,-158
"2044","22/01/2008",5569,5569,5222,5222,-347,-416,-347,-1110,-347
"2045","23/01/2008",5264,5568,5264,5446,182,182,182,546,182
"2046","24/01/2008",5481,5606,5479,5606,125,125,125,375,125
"2047","25/01/2008",5632,5886,5632,5886,125,114,421,660,254
"2048","29/01/2008",5888,5888,5737,5754,-134,-134,-130,-398,-134
"2049","30/01/2008",5781,5871,5661,5665,-140,-63,-29,-232,-116
"2050","31/01/2008",5657,5697,5507,5697,271,-406,24,-111,40
"2051","01/02/2008",5717,5888,5714,5882,207,14,-44,177,165
"2052","04/02/2008",5894,6058,5886,5922,44,28,28,100,28
"2053","05/02/2008",5921,5938,5845,5852,-69,-69,-69,-207,-69
"2054","06/02/2008",5830,5830,5678,5678,-314,-179,-219,-712,-152
"2055","07/02/2008",5676,5682,5586,5668,-194,8,-58,-244,-8
"2056","08/02/2008",5679,5767,5677,5724,250,157,49,456,45
"2057","11/02/2008",5728,5730,5584,5603,-304,-56,-200,-560,-125
"2058","12/02/2008",5616,5679,5583,5669,197,53,128,378,53
"2059","13/02/2008",5680,5719,5615,5615,71,-52,-77,-58,-65
"2060","14/02/2008",5636,5752,5636,5748,65,112,159,336,112
"2061","15/02/2008",5725,5725,5620,5680,1,304,-283,22,-45
"2062","19/02/2008",5656,5720,5655,5689,213,33,88,334,33
"2063","20/02/2008",5693,5701,5577,5577,-68,-147,-300,-515,-116
"2064","21/02/2008",5597,5679,5584,5663,-31,178,66,213,66
"2065","22/02/2008",5656,5661,5579,5644,1,-301,-469,-769,-12
"2066","25/02/2008",5655,5718,5653,5700,2,60,-37,25,45
"2067","26/02/2008",5706,5770,5706,5746,-15,165,-75,75,40
"2068","27/02/2008",5760,5846,5760,5842,124,15,145,284,82
"2069","28/02/2008",5836,5836,5712,5746,-90,7,-219,-302,-90
"2070","29/02/2008",5742,5743,5620,5675,40,-1,-75,-36,-67
"2071","03/03/2008",5639,5640,5500,5511,5,5,-245,-235,-128
"2072","04/03/2008",5515,5542,5451,5479,-290,-150,-137,-577,-36
"2073","05/03/2008",5489,5549,5443,5472,-76,-128,-76,-280,-17
"2074","06/03/2008",5492,5549,5469,5532,57,-42,57,72,40
"2075","07/03/2008",5511,5511,5346,5369,-135,-372,-201,-708,-142
"2076","10/03/2008",5344,5344,5245,5276,-68,88,-68,-48,-68
"2077","11/03/2008",5241,5243,5164,5211,-30,-88,-30,-148,-30
"2078","12/03/2008",5262,5442,5262,5334,72,-35,72,109,72
"2079","13/03/2008",5336,5339,5206,5216,-175,-529,-101,-805,-120
"2080","14/03/2008",5235,5298,5234,5288,-126,53,53,-20,53
"2081","17/03/2008",5265,5266,5130,5173,-90,112,-161,-139,-92
"2082","18/03/2008",5159,5194,5145,5164,-136,-348,-136,-620,5
"2083","19/03/2008",5208,5349,5208,5349,115,443,360,918,141
"2084","20/03/2008",5303,5308,5182,5182,-182,-66,-234,-482,-121
"2085","25/03/2008",5219,5384,5219,5356,160,5,93,258,137
"2086","26/03/2008",5363,5431,5362,5421,115,-114,72,73,58
"2087","27/03/2008",5414,5421,5385,5418,4,38,-130,-88,4
"2088","28/03/2008",5418,5418,5333,5401,32,-38,-40,-46,-17
"2089","31/03/2008",5396,5424,5370,5410,-51,45,72,66,14
"2090","01/04/2008",5416,5425,5359,5414,59,-146,22,-65,-2
"2091","02/04/2008",5445,5567,5444,5545,70,-76,112,106,100
"2092","03/04/2008",5554,5646,5553,5646,-26,134,92,200,92
"2093","04/04/2008",5646,5697,5636,5664,18,18,18,54,18
"2094","07/04/2008",5684,5693,5661,5684,0,0,0,0,0
"2095","08/04/2008",5685,5691,5620,5634,-39,-51,-51,-141,-51
"2096","09/04/2008",5663,5670,5575,5584,-37,-49,-79,-165,-79
"2097","10/04/2008",5577,5577,5505,5516,81,-127,-63,-109,-61
"2098","11/04/2008",5512,5522,5458,5505,68,52,52,172,-7
"2099","14/04/2008",5478,5479,5380,5411,-38,-17,18,-37,-67
"2100","15/04/2008",5409,5484,5408,5466,79,57,108,244,57
"2101","16/04/2008",5488,5543,5487,5535,-252,31,-18,-239,47
"2102","17/04/2008",5574,5630,5568,5587,58,-47,13,24,13
"2103","18/04/2008",5576,5587,5472,5504,-78,122,-295,-251,-72
"2104","21/04/2008",5531,5666,5531,5664,213,373,207,793,133
"2105","22/04/2008",5662,5662,5594,5628,-34,-129,-9,-172,-34
"2106","23/04/2008",5628,5712,5628,5711,83,-90,10,3,83
"2107","24/04/2008",5698,5700,5625,5659,45,-48,-48,-51,-39
"2108","25/04/2008",5659,5659,5659,5659,52,-148,-141,-237,0
"2109","28/04/2008",5669,5736,5643,5670,-21,-125,12,-134,1
"2110","29/04/2008",5679,5692,5646,5673,-23,102,106,185,-6
"2111","30/04/2008",5646,5678,5590,5657,-14,130,-31,85,11
"2112","01/05/2008",5654,5655,5605,5653,-103,103,47,47,-1
"2113","02/05/2008",5668,5760,5665,5760,77,126,88,291,92
"2114","05/05/2008",5786,5815,5782,5798,-634,60,0,-574,12
"2115","06/05/2008",5801,5802,5755,5778,184,-1,14,197,-23
"2116","07/05/2008",5799,5824,5746,5758,5,-57,40,-12,-41
"2117","08/05/2008",5725,5812,5683,5801,-30,349,195,514,76
"2118","09/05/2008",5804,5883,5803,5844,-762,-103,35,-830,40
"2119","12/05/2008",5846,5911,5846,5894,97,110,117,324,48
"2120","13/05/2008",5894,5908,5864,5883,-89,-144,-110,-343,-11
"2121","14/05/2008",5892,5955,5882,5940,125,-50,121,196,48
"2122","15/05/2008",5942,5986,5934,5965,-131,74,87,30,23
"2123","16/05/2008",5999,6041,5993,6006,-32,-26,-39,-97,7
"2124","19/05/2008",6023,6060,6019,6035,-257,-103,-103,-463,12
"2125","20/05/2008",6031,6032,5980,5995,-80,12,12,-56,-36
"2126","21/05/2008",5960,5960,5903,5916,27,-135,-166,-274,-44
"2127","22/05/2008",5895,5954,5836,5920,113,-61,-160,-108,25
"2128","23/05/2008",5925,5933,5855,5866,-153,-175,93,-235,-59
"2129","26/05/2008",5846,5848,5800,5808,-166,-98,-114,-378,-38
"2130","27/05/2008",5807,5838,5807,5818,-14,-9,42,19,11
"2131","28/05/2008",5815,5824,5736,5754,-63,104,45,86,-61
"2132","29/05/2008",5766,5822,5766,5817,125,51,108,284,51
"2133","30/05/2008",5803,5803,5757,5774,-152,198,-114,-68,-29
"2134","02/06/2008",5774,5800,5721,5781,42,-19,37,60,7
"2135","03/06/2008",5786,5786,5698,5703,-57,3,15,-39,-83
"2136","04/06/2008",5699,5740,5676,5698,-121,-315,83,-353,-1
"2137","05/06/2008",5686,5688,5620,5634,-6,-18,-33,-57,-52
"2138","06/06/2008",5634,5721,5634,5691,85,410,31,526,57
"2139","10/06/2008",5674,5674,5544,5544,-207,-53,-82,-342,-130
"2140","11/06/2008",5542,5562,5500,5562,20,-188,20,-148,20
"2141","12/06/2008",5547,5547,5428,5433,-36,-427,-27,-490,-114
"2142","13/06/2008",5450,5480,5399,5480,30,237,30,297,30
"2143","16/06/2008",5490,5508,5462,5476,54,187,-42,199,-14
"2144","17/06/2008",5488,5526,5421,5526,97,58,86,241,38
"2145","18/06/2008",5523,5551,5492,5550,-304,24,100,-180,27
"2146","19/06/2008",5541,5541,5484,5484,-337,-110,-67,-514,-57
"2147","20/06/2008",5484,5491,5399,5412,-56,-53,-34,-143,-72
"2148","23/06/2008",5392,5417,5337,5409,251,-453,4,-198,17
"2149","24/06/2008",5411,5423,5374,5419,-81,188,79,186,8
"2150","25/06/2008",5398,5410,5342,5363,-56,-73,-80,-209,-35
"2151","26/06/2008",5369,5451,5368,5422,250,-25,133,358,53
"2152","27/06/2008",5379,5379,5266,5349,-222,113,-150,-259,-30
"2153","30/06/2008",5364,5416,5328,5333,250,-25,133,358,-31
"2154","01/07/2008",5346,5351,5261,5261,74,2,-82,-6,-85
"2155","02/07/2008",5247,5247,5187,5212,197,479,14,690,-35
"2156","03/07/2008",5170,5170,5069,5094,-180,-499,-180,-859,-76
"2157","04/07/2008",5100,5170,5100,5170,222,88,222,532,70
"2158","07/07/2008",5159,5161,5067,5092,88,-427,-46,-385,-67
"2159","08/07/2008",5092,5115,5021,5022,-76,-190,-76,-342,-70
"2160","09/07/2008",5039,5114,5039,5089,50,80,50,180,50
"2161","10/07/2008",5065,5067,4999,5020,88,31,55,174,-45
"2162","11/07/2008",5036,5074,5024,5068,90,-22,-129,-61,32
"2163","14/07/2008",5059,5059,4995,5008,12,-142,-46,-176,-51
"2164","15/07/2008",5006,5006,4890,4910,-15,-18,-18,-51,-96
"2165","16/07/2008",4891,4961,4880,4948,-228,-569,-75,-872,57
"2166","17/07/2008",4949,5003,4942,4977,263,-483,-82,-302,28
"2167","18/07/2008",4978,4984,4902,4915,-124,-231,-138,-493,-63
"2168","21/07/2008",4937,5075,4933,5075,82,46,66,194,138
"2169","22/07/2008",5072,5078,5023,5076,158,15,79,252,4
"2170","23/07/2008",5084,5210,5076,5162,54,-117,125,62,78
"2171","24/07/2008",5156,5202,5148,5188,54,32,-129,-43,32
"2172","25/07/2008",5190,5190,5003,5029,-314,-149,-129,-592,-161
"2173","28/07/2008",5020,5032,4958,4990,-203,155,210,162,-30
"2174","29/07/2008",4981,4984,4896,4923,-322,-141,92,-371,-58
"2175","30/07/2008",4943,5025,4931,5009,314,164,-53,425,66
"2176","31/07/2008",5028,5083,5028,5053,-18,40,-84,-62,25
"2177","01/08/2008",5047,5047,4947,4978,189,-45,129,273,-69
"2178","04/08/2008",4961,5006,4956,4958,134,-54,-46,34,-3
"2179","05/08/2008",4925,5236,4829,4882,-8,-8,-46,-62,-43
"2180","06/08/2008",4905,5028,4905,5018,58,559,70,687,113
"2181","07/08/2008",5026,5055,4992,5030,11,-37,-4,-30,4
"2182","08/08/2008",5017,5041,4965,5038,63,55,100,218,21
"2183","11/08/2008",5044,5096,5043,5069,32,110,-31,111,25
"2184","12/08/2008",5065,5106,5050,5090,-32,15,-52,-69,25
"2185","13/08/2008",5073,5074,4973,4996,-127,-126,-52,-305,-77
"2186","14/08/2008",5014,5111,5012,5039,-158,-19,100,-77,25
"2187","15/08/2008",5032,5055,5010,5039,-59,71,-92,-80,7
"2188","18/08/2008",5036,5088,4994,5044,220,-59,-119,42,8
"2189","19/08/2008",5025,5025,4930,4930,-34,-192,-74,-300,-95
"2190","20/08/2008",4941,4998,4938,4998,-48,250,45,247,57
"2191","21/08/2008",5010,5010,4944,4950,-213,-10,75,-148,-60
"2192","22/08/2008",4965,5015,4964,5010,16,-27,108,97,45
"2193","25/08/2008",5020,5110,5017,5090,-271,174,-44,-141,70
"2194","26/08/2008",5090,5090,4976,5082,-561,-8,-18,-587,-8
"2195","27/08/2008",5087,5112,5048,5088,219,-152,145,212,1
"2196","28/08/2008",5097,5162,5097,5143,255,271,283,809,46
"2197","29/08/2008",5151,5220,5146,5216,110,4,43,157,65
"2198","01/09/2008",5209,5210,5176,5200,76,-48,-48,-20,-9
"2199","02/09/2008",5182,5250,5182,5195,146,-41,87,192,13
"2200","03/09/2008",5184,5214,5108,5130,-79,-10,-221,-310,-54
"2201","04/09/2008",5123,5150,5024,5051,-145,-89,-130,-364,-72
"2202","05/09/2008",5022,5022,4910,4950,-156,-27,-78,-261,-72
"2203","08/09/2008",4950,5141,4950,5126,45,176,176,397,176
"2204","09/09/2008",5112,5112,5029,5042,-9,16,-247,-240,-70
"2205","10/09/2008",4997,4997,4912,4961,34,-41,-78,-85,-36
"2206","11/09/2008",4970,4972,4871,4872,15,-74,-120,-179,-98
"2207","12/09/2008",4889,4957,4887,4957,61,185,68,314,68
"2208","15/09/2008",4957,4958,4832,4875,-82,-279,49,-312,-82
"2209","16/09/2008",4839,4842,4739,4800,43,98,9,150,-39
"2210","17/09/2008",4808,4864,4749,4770,-38,-42,-38,-118,-38
"2211","18/09/2008",4722,4723,4575,4652,-60,-167,-60,-287,-70
"2212","19/09/2008",4679,4857,4679,4841,162,139,162,463,162
"2213","22/09/2008",4945,5050,4939,5050,216,33,-34,215,105
"2214","23/09/2008",5021,5021,4920,4958,-63,-63,-63,-189,-63
"2215","24/09/2008",4952,5015,4948,5008,284,31,56,371,56
"2216","25/09/2008",4984,5010,4957,4961,-117,-23,-40,-180,-23
"2217","26/09/2008",4968,5019,4874,4935,-81,-85,-115,-281,-33
"2218","29/09/2008",4935,4982,4815,4839,79,-122,-168,-211,-96
"2219","30/09/2008",4757,4757,4569,4631,-415,-146,-129,-690,-126
"2220","01/10/2008",4662,4814,4662,4814,222,88,222,532,152
"2221","02/10/2008",4816,4844,4771,4774,-160,17,7,-136,-42
"2222","03/10/2008",4736,4736,4646,4703,57,-59,-85,-87,-33
"2223","06/10/2008",4698,4698,4526,4545,-132,-153,-153,-438,-153
"2224","07/10/2008",4512,4626,4395,4598,315,282,315,912,86
"2225","08/10/2008",4549,4549,4364,4370,-105,-179,-179,-463,-179
"2226","09/10/2008",4372,4374,4249,4291,-81,-416,-81,-578,-81
"2227","10/10/2008",4250,4250,3939,3940,-310,-298,-310,-918,-310
"2228","13/10/2008",3966,4168,3966,4142,176,176,176,528,176
"2229","14/10/2008",4202,4404,4202,4312,110,110,110,330,110
"2230","15/10/2008",4307,4308,4242,4272,-180,-156,106,-230,-35
"2231","16/10/2008",4207,4207,3973,3988,-212,-260,-260,-732,-219
"2232","17/10/2008",4011,4122,3937,3945,-66,-66,-66,-198,-66
"2233","20/10/2008",3964,4099,3964,4099,135,135,135,405,135
"2234","21/10/2008",4135,4251,4134,4251,461,150,107,718,116
"2235","22/10/2008",4223,4223,4120,4120,-218,-142,36,-324,-103
"2236","23/10/2008",4061,4061,3937,3939,-86,-154,-148,-388,-122
"2237","24/10/2008",3936,3989,3800,3832,-180,-348,-180,-708,-104
"2238","27/10/2008",3835,3835,3726,3768,-67,160,-67,26,-67
"2239","28/10/2008",3761,3764,3694,3755,-27,-122,-27,-176,-6
"2240","29/10/2008",3793,3931,3783,3806,13,293,13,319,13
"2241","30/10/2008",3827,3976,3826,3957,197,211,-2,406,130
"2242","31/10/2008",3951,3983,3903,3983,249,114,-7,356,32
"2243","03/11/2008",4003,4173,3983,4173,389,-36,-16,337,170
"2244","04/11/2008",4154,4181,4095,4170,44,16,100,160,16
"2245","05/11/2008",4203,4292,4200,4287,35,84,100,219,84
"2246","06/11/2008",4240,4241,4102,4106,-134,-134,-134,-402,-134
"2247","07/11/2008",4064,4064,3929,4007,-57,-93,-95,-245,-57
"2248","10/11/2008",4020,4111,4020,4060,43,108,61,212,40
"2249","11/11/2008",4042,4043,3890,3922,-57,-158,-187,-402,-120
"2250","12/11/2008",3907,3920,3857,3884,47,-23,-94,-70,-23
"2251","13/11/2008",3840,3840,3672,3672,8,-168,-168,-328,-168
"2252","14/11/2008",3714,3824,3714,3726,12,-726,12,-702,12
"2253","17/11/2008",3709,3710,3608,3640,-11,-78,-113,-202,-69
"2254","18/11/2008",3624,3646,3501,3513,-76,-4,-76,-156,-111
"2255","19/11/2008",3527,3557,3430,3483,-44,-44,-44,-132,-44
"2256","20/11/2008",3452,3452,3328,3333,-119,-206,-119,-444,-119
"2257","21/11/2008",3308,3387,3202,3387,79,79,79,237,79
"2258","24/11/2008",3398,3415,3337,3389,-9,-78,-9,-96,-9
"2259","25/11/2008",3434,3575,3433,3575,90,141,184,415,141
"2260","26/11/2008",3570,3570,3478,3480,-148,42,-43,-149,-90
"2261","27/11/2008",3526,3591,3519,3528,149,192,110,451,2
"2262","28/11/2008",3542,3673,3542,3673,220,252,55,527,131
"2263","01/12/2008",3670,3670,3588,3619,-51,-105,-9,-165,-51
"2264","02/12/2008",3576,3576,3473,3473,-85,-93,-94,-272,-103
"2265","03/12/2008",3496,3559,3444,3476,-26,-107,-245,-378,-20
"2266","04/12/2008",3493,3544,3459,3468,-125,-172,-152,-449,-25
"2267","05/12/2008",3449,3490,3424,3427,-440,87,70,-283,-22
"2268","08/12/2008",3442,3568,3441,3554,338,157,119,614,112
"2269","09/12/2008",3575,3576,3495,3534,240,221,-111,350,-41
"2270","10/12/2008",3538,3584,3492,3573,354,212,-205,361,35
"2271","11/12/2008",3590,3602,3493,3534,207,-159,-43,5,-56
"2272","12/12/2008",3524,3524,3419,3452,89,-112,-72,-95,-72
"2273","15/12/2008",3474,3599,3474,3536,-157,21,62,-74,62
"2274","16/12/2008",3533,3533,3456,3499,-84,207,-101,22,-34
"2275","17/12/2008",3513,3574,3496,3515,7,-101,83,-11,2
"2276","18/12/2008",3521,3522,3466,3522,-19,-243,114,-148,1
"2277","19/12/2008",3500,3553,3456,3547,-302,-193,70,-425,47
"2278","22/12/2008",3551,3556,3489,3492,-89,-98,-31,-218,-59
"2279","23/12/2008",3487,3507,3436,3468,59,4,-14,49,-19
"2280","24/12/2008",3471,3530,3466,3515,-325,-68,41,-352,44
"2281","26/12/2008",3515,3515,3515,3515,55,151,126,332,0
"2282","29/12/2008",3526,3586,3511,3554,-2,16,176,190,28
"2283","30/12/2008",3557,3606,3534,3591,373,-42,-50,281,34
"2284","31/12/2008",3602,3666,3602,3659,188,132,58,378,57
"2285","02/01/2009",3661,3704,3622,3656,93,-31,-31,31,-5
"2286","05/01/2009",3680,3710,3623,3639,40,-170,43,-87,-41
"2287","06/01/2009",3643,3706,3643,3689,-21,-256,-79,-356,46
"2288","07/01/2009",3712,3762,3711,3728,184,15,20,219,16
"2289","08/01/2009",3699,3700,3615,3644,-162,-55,-55,-272,-55
"2290","09/01/2009",3654,3687,3644,3680,421,-51,86,456,26
"2291","12/01/2009",3669,3669,3603,3624,81,81,248,410,-45
"2292","13/01/2009",3609,3609,3556,3594,-179,-3,54,-128,-15
"2293","14/01/2009",3602,3628,3581,3624,-38,247,47,256,22
"2294","15/01/2009",3591,3592,3463,3477,-197,-76,-141,-414,-114
"2295","16/01/2009",3494,3519,3487,3495,-74,1,1,-72,1
"2296","19/01/2009",3500,3543,3500,3531,-46,163,31,148,31
"2297","20/01/2009",3509,3509,3394,3425,-104,-87,-8,-199,-84
"2298","21/01/2009",3410,3411,3364,3395,-30,-647,-15,-692,-15
"2299","22/01/2009",3407,3440,3398,3432,-41,-499,67,-473,25
"2300","23/01/2009",3419,3419,3300,3300,-144,-445,-53,-642,-119
"2301","27/01/2009",3329,3394,3327,3392,69,-13,69,125,63
"2302","28/01/2009",3398,3445,3366,3435,23,-237,11,-203,37
"2303","29/01/2009",3461,3496,3443,3461,-84,53,-148,-179,0
"2304","30/01/2009",3450,3485,3410,3478,-70,11,-45,-104,28
"2305","02/02/2009",3460,3467,3427,3444,-6,-63,106,37,-16
"2306","03/02/2009",3450,3516,3448,3449,-44,288,75,319,-1
"2307","04/02/2009",3444,3454,3375,3382,-125,4,-19,-140,-62
"2308","05/02/2009",3401,3404,3362,3373,-232,-189,256,-165,-28
"2309","06/02/2009",3383,3432,3383,3408,-415,18,147,-250,25
"2310","09/02/2009",3432,3463,3430,3446,115,-85,64,94,14
"2311","10/02/2009",3452,3459,3405,3429,476,61,104,641,-23
"2312","11/02/2009",3402,3418,3355,3418,236,276,-69,443,16
"2313","12/02/2009",3419,3493,3418,3458,226,-308,-63,-145,39
"2314","13/02/2009",3453,3498,3451,3497,372,56,58,486,44
"2315","16/02/2009",3488,3488,3446,3461,54,57,58,169,-27
"2316","17/02/2009",3454,3482,3398,3412,-57,-71,33,-95,-42
"2317","18/02/2009",3387,3389,3324,3367,-86,50,35,-1,-20
"2318","19/02/2009",3367,3423,3346,3398,45,-21,-72,-48,31
"2319","20/02/2009",3398,3399,3334,3353,-82,-23,-187,-292,-45
"2320","23/02/2009",3340,3340,3269,3304,99,103,-139,63,-36
"2321","24/02/2009",3288,3291,3255,3285,-63,-85,148,0,-3
"2322","25/02/2009",3306,3332,3271,3282,-107,-356,-107,-570,-24
"2323","26/02/2009",3282,3316,3276,3297,10,-370,45,-315,15
"2324","27/02/2009",3296,3314,3264,3297,-87,-167,108,-146,1
"2325","02/03/2009",3283,3284,3191,3204,84,-196,-200,-312,-79
"2326","03/03/2009",3204,3204,3113,3171,-173,-541,-130,-844,-33
"2327","04/03/2009",3161,3164,3102,3126,-173,-58,-87,-318,-35
"2328","05/03/2009",3154,3177,3141,3149,35,-119,-5,-89,-5
"2329","06/03/2009",3132,3133,3092,3112,-25,-335,69,-291,-20
"2330","09/03/2009",3128,3143,3104,3122,-12,-379,-111,-502,-6
"2331","10/03/2009",3116,3143,3091,3143,290,-224,75,141,27
"2332","11/03/2009",3171,3217,3171,3199,-306,-151,76,-381,28
"2333","12/03/2009",3208,3225,3181,3190,-44,-34,160,82,-18
"2334","13/03/2009",3208,3302,3207,3295,97,117,160,374,87
"2335","16/03/2009",3296,3322,3289,3297,96,-38,-21,37,1
"2336","17/03/2009",3300,3393,3299,3393,81,81,93,255,93
"2337","18/03/2009",3396,3426,3376,3386,-10,-10,-10,-30,-10
"2338","19/03/2009",3394,3436,3394,3417,11,21,-219,-187,23
"2339","20/03/2009",3432,3433,3405,3405,97,-179,-27,-109,-27
"2340","23/03/2009",3408,3483,3397,3483,85,100,161,346,75
"2341","24/03/2009",3508,3575,3508,3517,97,9,9,115,9
"2342","25/03/2009",3517,3561,3499,3546,27,29,29,85,29
"2343","26/03/2009",3548,3603,3541,3586,-5,12,12,19,38
"2344","27/03/2009",3595,3646,3595,3616,-5,21,21,37,21
"2345","30/03/2009",3603,3604,3544,3554,44,-49,-49,-54,-49
"2346","31/03/2009",3539,3567,3520,3532,219,316,120,655,-7
"2347","01/04/2009",3534,3547,3504,3527,-14,-83,124,27,-7
"2348","02/04/2009",3540,3641,3539,3622,41,56,222,319,82
"2349","03/04/2009",3643,3688,3643,3674,-718,-243,-166,-1127,31
"2350","06/04/2009",3673,3701,3673,3696,244,-2,-9,233,23
"2351","07/04/2009",3685,3685,3646,3648,228,25,-18,235,-37
"2352","08/04/2009",3636,3636,3560,3568,496,321,208,1025,-68
"2353","09/04/2009",3574,3620,3574,3618,38,251,43,332,44
"2354","14/04/2009",3640,3718,3639,3698,8,-147,87,-52,58
"2355","15/04/2009",3692,3708,3682,3694,-600,-80,-216,-896,2
"2356","16/04/2009",3699,3750,3699,3726,217,-39,-134,44,27
"2357","17/04/2009",3735,3796,3728,3728,-839,-269,-142,-1250,-7
"2358","20/04/2009",3729,3739,3687,3723,128,103,-27,204,-6
"2359","21/04/2009",3696,3696,3618,3633,591,-33,-76,482,-63
"2360","22/04/2009",3643,3658,3621,3627,61,150,-64,147,-16
"2361","23/04/2009",3634,3697,3633,3696,-5,63,43,101,62
"2362","24/04/2009",3697,3707,3645,3668,-151,87,86,22,-29
"2363","27/04/2009",3680,3735,3643,3690,149,-253,61,-43,10
"2364","28/04/2009",3687,3734,3664,3672,190,149,52,391,-15
"2365","29/04/2009",3660,3687,3646,3662,161,54,127,342,2
"2366","30/04/2009",3662,3761,3662,3745,-48,88,124,164,83
"2367","01/05/2009",3737,3748,3721,3738,128,-66,47,109,1
"2368","04/05/2009",3748,3846,3748,3846,620,430,14,1064,98
"2369","05/05/2009",3863,3907,3849,3862,63,-75,-75,-87,-1
"2370","06/05/2009",3862,3878,3826,3840,-220,-66,-66,-352,-22
"2371","07/05/2009",3861,3926,3861,3912,112,-157,81,36,51
"2372","08/05/2009",3895,3920,3884,3920,63,3,3,69,25
"2373","11/05/2009",3921,3942,3887,3910,-67,-144,-110,-321,-11
"2374","12/05/2009",3900,3900,3844,3864,125,-11,55,169,-36
"2375","13/05/2009",3864,3880,3827,3842,47,-38,-244,-235,-22
"2376","14/05/2009",3814,3814,3710,3711,-308,-128,-208,-644,-103
"2377","15/05/2009",3728,3776,3727,3759,31,65,42,138,31
"2378","18/05/2009",3750,3750,3704,3722,18,-53,-268,-303,-28
"2379","19/05/2009",3742,3804,3742,3801,-63,57,-2,-8,59
"2380","20/05/2009",3808,3815,3779,3809,73,-147,49,-25,1
"2381","21/05/2009",3809,3817,3782,3805,-104,7,70,-27,-4
"2382","22/05/2009",3789,3790,3744,3755,27,9,10,46,-34
"2383","25/05/2009",3757,3778,3720,3735,41,17,174,232,-22
"2384","26/05/2009",3734,3782,3722,3782,44,71,174,289,48
"2385","27/05/2009",3791,3828,3790,3795,17,-130,190,77,4
"2386","28/05/2009",3780,3780,3737,3754,-44,122,26,104,-26
"2387","29/05/2009",3754,3817,3754,3813,-72,159,35,122,59
"2388","01/06/2009",3813,3888,3808,3888,1,139,101,241,75
"2389","02/06/2009",3903,3957,3903,3948,35,11,17,63,45
"2390","03/06/2009",3948,4009,3943,4009,-239,61,61,-117,61
"2391","04/06/2009",4009,4009,3926,3932,-26,-77,-77,-180,-77
"2392","05/06/2009",3932,4017,3932,3969,52,-60,-12,-20,37
"2393","09/06/2009",3959,3993,3934,3934,-79,32,-4,-51,-25
"2394","10/06/2009",3948,4016,3947,4016,195,349,250,794,68
"2395","11/06/2009",4014,4052,4013,4047,249,-103,-62,84,33
"2396","12/06/2009",4047,4078,4039,4062,157,-39,-44,74,15
"2397","15/06/2009",4050,4059,4030,4030,18,-50,-8,-40,-20
"2398","16/06/2009",4014,4016,3950,3958,591,-33,-76,482,-56
"2399","17/06/2009",3942,3942,3876,3904,32,-3,-48,-19,-38
"2400","18/06/2009",3897,3915,3869,3887,-247,-98,45,-300,-10
"2401","19/06/2009",3894,3927,3893,3894,-12,-137,-10,-159,0
"2402","22/06/2009",3902,3925,3891,3911,176,-82,45,139,9
"2403","23/06/2009",3884,3884,3787,3793,-30,-29,23,-36,-91
"2404","24/06/2009",3797,3807,3767,3802,78,5,5,88,5
"2405","25/06/2009",3809,3853,3809,3852,156,100,43,299,43
"2406","26/06/2009",3859,3910,3859,3900,192,150,4,346,41
"2407","29/06/2009",3896,3922,3880,3883,223,-193,48,78,-13
"2408","30/06/2009",3895,3948,3894,3948,143,-80,-30,33,53
"2409","01/07/2009",3934,3934,3858,3872,-32,-145,-61,-238,-62
"2410","02/07/2009",3884,3908,3871,3875,124,192,-42,274,-9
"2411","03/07/2009",3859,3859,3804,3827,-215,123,-60,-152,-32
"2412","06/07/2009",3820,3820,3769,3784,44,18,15,77,-36
"2413","07/07/2009",3779,3786,3762,3768,144,-7,-51,86,-11
"2414","08/07/2009",3753,3766,3710,3766,-56,419,20,383,13
"2415","09/07/2009",3764,3767,3740,3761,81,299,2,382,-3
"2416","10/07/2009",3762,3793,3761,3791,138,175,-230,83,29
"2417","13/07/2009",3787,3790,3736,3738,-322,116,-157,-363,-49
"2418","14/07/2009",3756,3859,3756,3859,3,160,88,251,103
"2419","15/07/2009",3863,3922,3862,3918,49,-66,55,38,55
"2420","16/07/2009",3936,4012,3935,3988,52,52,16,120,52
"2421","17/07/2009",3993,4017,3981,3993,-12,0,0,-12,0
"2422","20/07/2009",3998,4059,3998,4044,63,38,46,147,46
"2423","21/07/2009",4053,4079,4042,4048,-26,-5,-5,-36,-5
"2424","22/07/2009",4052,4074,4046,4069,107,17,17,141,17
"2425","23/07/2009",4061,4077,4053,4073,63,-115,12,-40,12
"2426","24/07/2009",4088,4130,4088,4097,93,-15,-29,49,9
"2427","27/07/2009",4105,4161,4105,4148,205,33,161,399,43
"2428","28/07/2009",4149,4182,4149,4174,-75,100,-9,16,25
"2429","29/07/2009",4163,4183,4148,4149,185,12,14,211,-14
"2430","30/07/2009",4145,4206,4142,4196,106,104,81,291,51
"2431","31/07/2009",4216,4252,4214,4250,36,41,112,189,34
"2432","03/08/2009",4252,4288,4250,4270,-88,33,33,-22,18
"2433","04/08/2009",4295,4346,4295,4314,-32,19,19,6,19
"2434","05/08/2009",4325,4325,4272,4272,-239,-54,-54,-347,-53
"2435","06/08/2009",4278,4331,4278,4331,27,50,-13,64,53
"2436","07/08/2009",4322,4322,4282,4303,184,-124,-83,-23,-19
"2437","10/08/2009",4314,4352,4305,4309,425,-119,26,332,-5
"2438","11/08/2009",4304,4335,4286,4334,-30,409,-85,294,30
"2439","12/08/2009",4325,4354,4300,4346,128,103,-27,204,21
"2440","13/08/2009",4354,4437,4354,4437,210,445,197,852,83
"2441","14/08/2009",4447,4506,4447,4465,141,-12,27,156,18
"2442","17/08/2009",4456,4456,4398,4398,-162,-129,-95,-386,-58
"2443","18/08/2009",4386,4401,4358,4386,510,362,210,1082,0
"2444","19/08/2009",4386,4444,4382,4388,-14,122,82,190,2
"2445","20/08/2009",4409,4437,4381,4391,85,-2,129,212,-18
"2446","21/08/2009",4391,4395,4278,4306,-243,-125,-98,-466,-85
"2447","24/08/2009",4330,4434,4329,4434,130,184,152,466,104
"2448","25/08/2009",4431,4442,4400,4418,103,430,180,713,-13
"2449","26/08/2009",4419,4477,4419,4464,174,170,-392,-48,45
"2450","27/08/2009",4461,4468,4435,4458,-3,339,26,362,-3
"2451","28/08/2009",4466,4497,4466,4496,106,362,71,539,30
"2452","31/08/2009",4493,4540,4476,4484,-656,-39,-197,-892,-9
"2453","01/09/2009",4482,4520,4470,4511,425,102,14,541,29
"2454","02/09/2009",4491,4491,4412,4437,-559,-248,-105,-912,-54
"2455","03/09/2009",4433,4448,4412,4433,-276,-399,-108,-783,0
"2456","04/09/2009",4445,4480,4441,4443,46,383,78,507,-2
"2457","07/09/2009",4450,4474,4448,4461,-256,-94,97,-253,11
"2458","08/09/2009",4467,4530,4467,4528,-111,182,115,186,61
"2459","09/09/2009",4535,4558,4511,4527,172,-40,33,165,-8
"2460","10/09/2009",4528,4579,4528,4574,524,137,-22,639,46
"2461","11/09/2009",4578,4607,4578,4596,-668,42,7,-619,18
"2462","14/09/2009",4596,4596,4525,4536,36,-7,-49,-20,-60
"2463","15/09/2009",4545,4587,4536,4547,393,98,249,740,2
"2464","16/09/2009",4558,4654,4558,4653,-124,148,119,143,95
"2465","17/09/2009",4663,4747,4663,4714,-32,74,87,129,51
"2466","18/09/2009",4703,4704,4662,4694,63,39,39,141,-9
"2467","21/09/2009",4689,4704,4673,4684,38,15,63,116,-5
"2468","22/09/2009",4679,4688,4664,4671,-21,-269,-175,-465,-8
"2469","23/09/2009",4671,4742,4671,4741,195,426,73,694,70
"2470","24/09/2009",4730,4732,4701,4708,18,63,-10,71,-22
"2471","25/09/2009",4695,4727,4646,4715,543,-1,193,735,20
"2472","28/09/2009",4706,4708,4650,4677,-154,160,149,155,-29
"2473","29/09/2009",4694,4762,4694,4747,-201,60,12,-129,53
"2474","30/09/2009",4742,4760,4726,4739,584,93,-108,569,-3
"2475","01/10/2009",4736,4753,4698,4702,364,371,68,803,-34
"2476","02/10/2009",4676,4676,4604,4606,173,-312,-91,-230,-70
"2477","05/10/2009",4606,4621,4579,4579,-226,-53,-27,-306,-27
"2478","06/10/2009",4594,4645,4589,4597,-107,-85,-167,-359,3
"2479","07/10/2009",4617,4706,4616,4696,85,224,154,463,79
"2480","08/10/2009",4697,4773,4689,4763,143,-163,50,30,66
"2481","09/10/2009",4774,4799,4750,4754,-744,-31,35,-740,-20
"2482","12/10/2009",4762,4789,4743,4746,89,-243,-94,-248,-16
"2483","13/10/2009",4749,4800,4749,4790,20,430,-59,391,41
"2484","14/10/2009",4787,4842,4786,4834,-244,-13,-54,-311,47
"2485","15/10/2009",4847,4898,4847,4862,-162,-211,15,-358,15
"2486","16/10/2009",4862,4880,4841,4843,-257,-17,41,-233,-19
"2487","19/10/2009",4837,4837,4782,4802,152,73,-35,190,-35
"2488","20/10/2009",4816,4876,4816,4853,104,-80,54,78,37
"2489","21/10/2009",4846,4849,4827,4846,204,64,3,271,0
"2490","22/10/2009",4839,4850,4817,4819,-18,267,82,331,-20
"2491","23/10/2009",4831,4869,4831,4860,-26,173,-521,-374,29
"2492","26/10/2009",4848,4849,4815,4833,147,-38,82,191,-15
"2493","27/10/2009",4818,4818,4753,4755,-4,-78,-469,-551,-63
"2494","28/10/2009",4753,4766,4685,4687,-152,-98,-140,-390,-66
"2495","29/10/2009",4659,4659,4563,4575,7,-9,-106,-108,-84
"2496","30/10/2009",4601,4675,4601,4647,46,63,46,155,46
"2497","02/11/2009",4617,4617,4521,4546,-173,-170,-94,-437,-71
"2498","03/11/2009",4553,4584,4528,4540,69,90,69,228,-13
"2499","04/11/2009",4543,4566,4527,4548,-60,-226,-60,-346,5
"2500","05/11/2009",4545,4569,4515,4519,115,-427,31,-281,-26
"2501","06/11/2009",4537,4604,4537,4604,67,397,-27,437,67
"2502","09/11/2009",4607,4692,4607,4686,-1,441,-66,374,79
"2503","10/11/2009",4706,4768,4705,4744,288,37,38,363,38
"2504","11/11/2009",4746,4775,4745,4766,-14,20,20,26,20
"2505","12/11/2009",4770,4802,4757,4758,77,38,-12,103,-12
"2506","13/11/2009",4745,4745,4707,4723,96,-38,-21,37,-22
"2507","16/11/2009",4732,4775,4732,4774,124,-45,81,160,42
"2508","17/11/2009",4786,4817,4750,4750,47,21,16,84,-36
"2509","18/11/2009",4757,4798,4755,4760,-2,-22,14,-10,3
"2510","19/11/2009",4764,4780,4749,4768,-152,62,-22,-112,4
"2511","20/11/2009",4754,4754,4695,4707,-67,-75,-133,-275,-47
"2512","23/11/2009",4710,4746,4705,4739,-322,-22,62,-282,29
"2513","24/11/2009",4746,4784,4708,4708,-299,-308,60,-547,-38
"2514","25/11/2009",4713,4741,4697,4741,-40,41,115,116,28
"2515","26/11/2009",4749,4768,4719,4728,-30,62,146,178,-21
"2516","27/11/2009",4697,4697,4588,4597,-164,-253,26,-391,-100
"2517","30/11/2009",4615,4721,4615,4716,7,163,101,271,101
"2518","01/12/2009",4712,4733,4694,4733,-99,59,-39,-79,21
"2519","02/12/2009",4746,4806,4746,4777,302,110,129,541,31
"2520","03/12/2009",4779,4799,4769,4789,172,-98,25,99,10
"2521","04/12/2009",4777,4777,4707,4721,-260,-99,-101,-460,-56
"2522","07/12/2009",4726,4740,4672,4695,-247,-396,-16,-659,-31
"2523","08/12/2009",4695,4711,4672,4686,-30,-122,7,-145,-9
"2524","09/12/2009",4679,4679,4614,4653,66,-100,9,-25,-26
"2525","10/12/2009",4652,4666,4614,4623,-38,-29,-13,-80,-29
"2526","11/12/2009",4628,4660,4628,4651,176,23,23,222,23
"2527","14/12/2009",4652,4668,4627,4668,-30,8,-13,-35,16
"2528","15/12/2009",4673,4703,4672,4688,9,-16,9,2,15
"2529","16/12/2009",4685,4701,4672,4676,-264,-322,-15,-601,-9
"2530","17/12/2009",4686,4719,4668,4690,27,141,26,194,4
"2531","18/12/2009",4675,4678,4629,4672,-26,-138,-20,-184,-3
"2532","21/12/2009",4680,4711,4660,4660,102,-112,-40,-50,-20
"2533","22/12/2009",4667,4724,4667,4724,7,79,-15,71,57
"2534","23/12/2009",4725,4759,4716,4756,15,306,44,365,31
"2535","24/12/2009",4765,4803,4765,4803,77,-9,29,97,38
"2536","29/12/2009",4809,4868,4809,4857,49,110,117,276,48
"2537","30/12/2009",4856,4878,4846,4847,-327,-103,-103,-533,-9
"2538","31/12/2009",4855,4884,4855,4883,-37,28,14,5,28
"2539","04/01/2010",4878,4901,4876,4890,-104,44,20,-40,12
"2540","05/01/2010",4900,4945,4900,4940,181,105,24,310,40
"2541","06/01/2010",4944,4955,4936,4947,-232,-66,-66,-364,3
"2542","07/01/2010",4948,4964,4930,4930,157,-6,-21,130,-18
"2543","08/01/2010",4931,4964,4931,4942,98,85,29,212,11
"2544","11/01/2010",4951,4984,4950,4981,149,50,0,199,30
"2545","12/01/2010",4971,4972,4926,4932,-839,-269,-142,-1250,-39
"2546","13/01/2010",4920,4920,4885,4900,301,-8,43,336,-20
"2547","14/01/2010",4907,4950,4906,4929,108,70,9,187,22
"2548","15/01/2010",4928,4939,4893,4930,-209,-112,-307,-628,2
"2549","18/01/2010",4921,4942,4896,4936,-122,129,-436,-429,15
"2550","19/01/2010",4939,4953,4890,4890,79,97,-436,-260,-49
"2551","20/01/2010",4902,4933,4893,4895,116,63,55,234,-7
"2552","21/01/2010",4883,4883,4845,4850,28,130,79,237,-33
"2553","22/01/2010",4820,4820,4741,4772,-74,149,18,93,-48
"2554","25/01/2010",4750,4750,4703,4743,7,142,-7,142,-7
"2555","27/01/2010",4733,4734,4655,4670,-119,559,-7,433,-63
"2556","28/01/2010",4677,4699,4668,4698,-158,-120,21,-257,21
"2557","29/01/2010",4683,4683,4593,4597,-134,-427,-152,-713,-86
"2558","01/02/2010",4596,4609,4545,4545,90,185,-51,224,-51
"2559","02/02/2010",4568,4629,4567,4629,-1,85,-1,83,61
"2560","03/02/2010",4652,4683,4646,4673,-9,-396,33,-372,21
"2561","04/02/2010",4665,4666,4624,4644,-11,39,-127,-99,-21
"2562","05/02/2010",4608,4610,4508,4532,107,-118,-119,-130,-76
"2563","08/02/2010",4539,4568,4535,4539,-41,-157,-18,-216,0
"2564","09/02/2010",4532,4532,4483,4521,186,-349,-160,-323,-11
"2565","10/02/2010",4546,4587,4520,4533,131,522,257,910,-13
"2566","11/02/2010",4532,4584,4531,4576,-24,-50,55,-19,44
"2567","12/02/2010",4587,4616,4571,4589,44,235,-129,150,2
"2568","15/02/2010",4586,4593,4564,4570,86,-46,141,181,-16
"2569","16/02/2010",4575,4620,4575,4591,226,-114,-204,-92,16
"2570","17/02/2010",4608,4691,4607,4687,310,288,147,745,79
"2571","18/02/2010",4691,4693,4655,4674,81,138,-11,208,-17
"2572","19/02/2010",4680,4691,4633,4656,59,-125,22,-44,-24
"2573","22/02/2010",4673,4733,4673,4733,266,-22,94,338,60
"2574","23/02/2010",4722,4731,4703,4731,96,33,-94,35,9
"2575","24/02/2010",4717,4717,4659,4666,-48,36,-80,-92,-51
"2576","25/02/2010",4673,4706,4612,4615,-38,-97,319,184,-58
"2577","26/02/2010",4626,4651,4613,4651,-5,19,-178,-164,25
"2578","01/03/2010",4647,4695,4647,4695,-86,174,-185,-97,48
"2579","02/03/2010",4702,4724,4694,4710,-93,-53,333,187,8
"2580","03/03/2010",4716,4752,4714,4744,203,-96,216,323,28
"2581","04/03/2010",4750,4759,4734,4758,172,79,-63,188,8
"2582","05/03/2010",4760,4786,4759,4773,106,230,106,442,13
"2583","08/03/2010",4792,4836,4792,4820,-260,42,-76,-294,28
"2584","09/03/2010",4818,4836,4802,4829,49,110,117,276,11
"2585","10/03/2010",4828,4845,4815,4830,37,-42,5,0,2
"2586","11/03/2010",4831,4851,4819,4826,-682,-90,-225,-997,-5
"2587","12/03/2010",4826,4847,4825,4832,425,50,106,581,6
"2588","15/03/2010",4834,4849,4799,4799,476,-260,180,396,-35
"2589","16/03/2010",4801,4819,4794,4809,-331,-193,-9,-533,8
"2590","17/03/2010",4817,4867,4817,4867,94,-193,-183,-282,50
"2591","18/03/2010",4874,4888,4863,4878,279,61,256,596,4
"2592","19/03/2010",4877,4892,4871,4890,374,46,195,615,13
"2593","22/03/2010",4877,4877,4845,4848,374,200,82,656,-29
"2594","23/03/2010",4856,4895,4855,4888,-331,-52,-57,-440,32
"2595","24/03/2010",4897,4921,4897,4903,-114,121,303,310,6
"2596","25/03/2010",4896,4901,4883,4896,482,-190,180,472,0
"2597","26/03/2010",4890,4905,4848,4905,219,-176,212,255,15
"2598","29/03/2010",4910,4920,4900,4907,242,-236,-49,-43,-3
"2599","30/03/2010",4917,4932,4915,4927,96,122,93,311,10
"2600","31/03/2010",4922,4941,4893,4893,312,-164,-29,119,-29
"2601","01/04/2010",4897,4926,4897,4926,-400,-301,-133,-834,29
"2602","06/04/2010",4942,4976,4942,4974,-14,122,82,190,32
"2603","07/04/2010",4975,4992,4975,4983,-472,-31,-67,-570,8
"2604","08/04/2010",4969,4970,4954,4960,24,-132,120,12,-9
"2605","09/04/2010",4965,4982,4965,4973,421,253,227,901,8
"2606","12/04/2010",4981,5013,4981,5012,-124,148,119,143,31
"2607","13/04/2010",5007,5007,4972,4978,-279,76,-79,-282,-29
"2608","14/04/2010",4984,5020,4984,5018,421,181,-65,537,34
"2609","15/04/2010",5026,5049,5024,5024,210,445,197,852,-2
"2610","16/04/2010",5022,5024,4997,5007,476,392,73,941,-15
"2611","19/04/2010",4990,4990,4934,4939,420,-218,-88,114,-51
"2612","20/04/2010",4938,4970,4938,4950,68,90,6,164,12
"2613","21/04/2010",4951,4994,4951,4980,68,251,75,394,29
"2614","22/04/2010",4971,4971,4918,4937,-37,-268,162,-143,-34
"2615","23/04/2010",4934,4934,4909,4914,73,344,13,430,-20
"2616","27/04/2010",4918,4944,4907,4913,21,76,78,175,-5
"2617","28/04/2010",4886,4888,4817,4854,15,-63,-57,-105,-32
"2618","29/04/2010",4850,4851,4813,4816,10,-370,45,-315,-34
"2619","30/04/2010",4823,4851,4821,4834,11,-404,-109,-502,11
"2620","03/05/2010",4812,4812,4778,4807,-24,-170,-161,-355,-5
"2621","04/05/2010",4802,4825,4753,4753,-31,10,-26,-47,-49
"2622","05/05/2010",4731,4731,4651,4692,-87,-37,-87,-211,-39
"2623","06/05/2010",4675,4675,4596,4599,-71,-569,-71,-711,-76
"2624","07/05/2010",4569,4573,4450,4507,-1,63,-1,61,-62
"2625","10/05/2010",4521,4622,4521,4622,101,-13,101,189,101
"2626","11/05/2010",4630,4654,4573,4573,27,-203,-63,-239,-57
"2627","12/05/2010",4580,4638,4580,4600,-23,-118,-27,-168,20
"2628","13/05/2010",4614,4680,4614,4680,81,-26,17,72,66
"2629","14/05/2010",4668,4668,4628,4643,174,153,142,469,-25
"2630","17/05/2010",4622,4622,4501,4501,-196,-386,-129,-711,-121
"2631","18/05/2010",4511,4534,4478,4500,65,-541,-42,-518,-11
"2632","19/05/2010",4487,4489,4414,4414,-89,-25,-157,-271,-73
"2633","20/05/2010",4418,4428,4342,4342,-75,-357,55,-377,-76
"2634","21/05/2010",4315,4327,4194,4326,64,90,64,218,11
"2635","24/05/2010",4338,4413,4324,4413,-47,-34,-47,-128,75
"2636","25/05/2010",4395,4395,4286,4286,56,-158,-152,-254,-109
"2637","26/05/2010",4313,4383,4313,4330,-106,-262,-106,-474,17
"2638","27/05/2010",4336,4399,4316,4399,219,-40,55,234,63
"2639","28/05/2010",4415,4480,4415,4479,196,53,187,436,64
"2640","31/05/2010",4470,4474,4449,4454,124,194,127,445,-16
"2641","01/06/2010",4454,4454,4411,4437,266,62,-17,311,-17
"2642","02/06/2010",4428,4450,4397,4404,99,1,20,120,-24
"2643","03/06/2010",4424,4508,4424,4506,478,42,95,615,82
"2644","04/06/2010",4493,4493,4455,4472,65,-33,-21,11,-21
"2645","07/06/2010",4438,4438,4326,4351,-81,1,-73,-153,-87
"2646","08/06/2010",4348,4404,4348,4401,-154,-29,122,-61,53
"2647","09/06/2010",4406,4409,4374,4403,-20,155,83,218,-3
"2648","10/06/2010",4403,4459,4403,4448,-211,52,92,-67,45
"2649","11/06/2010",4468,4518,4468,4516,458,-45,-12,401,48
"2650","15/06/2010",4517,4528,4503,4518,222,-24,-89,109,1
"2651","17/06/2010",4570,4578,4535,4547,-626,-14,-24,-664,-23
"2652","18/06/2010",4547,4582,4546,4574,-423,-60,-102,-585,27
"2653","21/06/2010",4588,4641,4588,4633,18,13,-2,29,45
"2654","22/06/2010",4625,4625,4580,4581,37,-66,-66,-95,-44
"2655","23/06/2010",4568,4569,4509,4509,17,-37,-53,-73,-59
"2656","24/06/2010",4524,4542,4503,4504,133,17,-10,140,-20
"2657","25/06/2010",4493,4493,4436,4439,-157,70,41,-46,-54
"2658","28/06/2010",4445,4458,4394,4410,-12,-23,-35,-70,-35
"2659","29/06/2010",4407,4433,4368,4371,-7,-36,5,-38,-36
"2660","30/06/2010",4347,4347,4273,4325,-23,-22,-204,-249,-22
"2661","01/07/2010",4310,4311,4240,4263,7,-279,59,-213,-47
"2662","02/07/2010",4273,4304,4249,4265,-8,66,-15,43,-8
"2663","05/07/2010",4266,4286,4245,4251,-17,47,-141,-111,-15
"2664","06/07/2010",4244,4300,4213,4300,36,306,35,377,56
"2665","07/07/2010",4303,4312,4259,4278,-33,-272,-58,-363,-25
"2666","08/07/2010",4298,4374,4298,4374,159,101,-58,202,76
"2667","09/07/2010",4377,4415,4370,4414,83,116,-39,160,37
"2668","12/07/2010",4415,4440,4408,4430,55,36,-56,35,15
"2669","13/07/2010",4424,4446,4400,4400,65,14,-75,4,-24
"2670","14/07/2010",4418,4477,4417,4477,75,-55,3,23,59
"2671","15/07/2010",4472,4478,4444,4457,-15,-51,19,-47,-15
"2672","16/07/2010",4457,4470,4428,4437,20,-63,-56,-99,-20
"2673","19/07/2010",4420,4420,4360,4373,-57,58,2,3,-47
"2674","20/07/2010",4378,4428,4376,4419,34,146,-104,76,41
"2675","21/07/2010",4430,4450,4418,4429,356,-39,127,444,-1
"2676","22/07/2010",4426,4431,4395,4395,252,-74,56,234,-31
"2677","23/07/2010",4412,4489,4412,4475,-18,15,178,175,63
"2678","26/07/2010",4483,4519,4483,4504,21,-78,0,-57,21
"2679","27/07/2010",4507,4537,4504,4514,-472,-132,69,-535,7
"2680","28/07/2010",4514,4542,4503,4542,-279,308,53,82,28
"2681","29/07/2010",4541,4543,4518,4536,-682,-11,-98,-791,-5
"2682","30/07/2010",4531,4532,4495,4507,142,49,-7,184,-24
"2683","02/08/2010",4509,4554,4508,4554,-95,-3,-10,-108,45
"2684","03/08/2010",4569,4598,4568,4586,-279,-39,-75,-393,17
"2685","04/08/2010",4584,4584,4559,4560,-656,-272,-173,-1101,-24
"2686","05/08/2010",4567,4597,4567,4585,187,59,72,318,18
"2687","06/08/2010",4583,4586,4567,4586,-154,137,60,43,3
"2688","09/08/2010",4581,4619,4561,4616,264,-154,36,146,35
"2689","10/08/2010",4614,4618,4561,4563,52,-50,120,122,-51
"2690","11/08/2010",4555,4556,4480,4480,-400,129,9,-262,-75
"2691","12/08/2010",4462,4462,4406,4422,-70,-87,65,-92,-40
"2692","13/08/2010",4424,4481,4417,4481,140,93,57,290,57
"2693","16/08/2010",4471,4476,4430,4465,-197,-1,250,52,-6
"2694","17/08/2010",4465,4511,4454,4503,118,183,152,453,38
"2695","18/08/2010",4490,4524,4489,4504,-219,42,10,-167,14
"2696","19/08/2010",4498,4510,4488,4510,128,225,70,423,12
"2697","20/08/2010",4498,4499,4443,4462,-173,-399,-368,-940,-36
"2698","23/08/2010",4464,4471,4450,4460,213,-58,-64,91,-4
"2699","24/08/2010",4455,4455,4416,4418,-50,-35,-84,-169,-37
"2700","25/08/2010",4408,4408,4351,4357,33,2,-82,-47,-51
"2701","26/08/2010",4361,4389,4356,4389,47,-374,-51,-378,28
"2702","27/08/2010",4382,4411,4366,4404,82,-198,62,-54,22
"2703","30/08/2010",4414,4486,4413,4483,186,-235,137,88,69
"2704","31/08/2010",4471,4473,4438,4439,-13,37,34,58,-32
"2705","01/09/2010",4447,4531,4447,4527,40,-70,176,146,80
"2706","02/09/2010",4542,4583,4542,4563,284,-87,66,263,21
"2707","03/09/2010",4567,4589,4565,4578,-71,126,124,179,11
"2708","06/09/2010",4583,4616,4583,4616,94,-124,122,92,33
"2709","07/09/2010",4611,4630,4597,4613,-257,-17,41,-233,2
"2710","08/09/2010",4602,4607,4575,4578,-19,33,-29,-15,-24
"2711","09/09/2010",4581,4631,4581,4621,255,60,3,318,40
"2712","10/09/2010",4622,4635,4600,4601,-839,-44,7,-876,-21
"2713","13/09/2010",4613,4661,4613,4654,0,222,53,275,41
"2714","14/09/2010",4661,4689,4661,4669,-596,-87,-22,-705,8
"2715","15/09/2010",4670,4710,4670,4703,-472,57,123,-292,33
"2716","16/09/2010",4703,4708,4649,4650,-718,63,-41,-696,-53
"2717","17/09/2010",4658,4692,4658,4685,443,338,181,962,27
"2718","20/09/2010",4680,4680,4653,4677,54,326,215,595,-3
"2719","21/09/2010",4684,4710,4665,4665,-122,46,222,146,-19
"2720","22/09/2010",4665,4688,4665,4675,-243,33,262,52,10
"2721","23/09/2010",4672,4681,4660,4680,-51,-125,262,86,8
"2722","24/09/2010",4670,4670,4635,4652,109,-243,-75,-209,-18
"2723","27/09/2010",4667,4727,4667,4722,33,70,82,185,55
"2724","28/09/2010",4718,4728,4705,4717,165,-23,246,388,-1
"2725","29/09/2010",4723,4743,4693,4694,288,-152,235,371,-29
"2726","30/09/2010",4694,4698,4637,4637,127,-147,-214,-234,-57
"2727","01/10/2010",4646,4668,4616,4635,63,256,48,367,-11
"2728","04/10/2010",4642,4695,4642,4678,-93,-3,148,52,36
"2729","05/10/2010",4668,4672,4615,4661,19,-118,71,-28,-7
"2730","06/10/2010",4674,4744,4674,4738,71,301,92,464,64
"2731","07/10/2010",4740,4750,4721,4746,52,311,31,394,6
"2732","08/10/2010",4740,4746,4724,4740,153,-56,150,247,0
"2733","11/10/2010",4746,4774,4746,4762,187,59,72,318,16
"2734","12/10/2010",4756,4757,4686,4686,128,-84,-55,-11,-70
"2735","13/10/2010",4694,4724,4690,4691,27,-65,60,22,-3
"2736","14/10/2010",4706,4768,4706,4766,173,85,83,341,60
"2737","15/10/2010",4759,4764,4731,4758,172,48,193,413,-1
"2738","18/10/2010",4758,4758,4711,4723,219,-75,144,288,-35
"2739","19/10/2010",4730,4752,4727,4727,133,313,-134,312,-3
"2740","20/10/2010",4714,4714,4653,4694,-365,-322,-185,-872,-20
"2741","21/10/2010",4705,4731,4695,4696,-87,-3,-178,-268,-9
"2742","22/10/2010",4700,4720,4696,4720,-221,-76,-210,-507,20
"2743","25/10/2010",4716,4794,4714,4781,217,-78,-81,58,65
"2744","26/10/2010",4780,4783,4758,4762,52,107,-35,124,-18
"2745","27/10/2010",4759,4771,4714,4720,364,99,84,547,-39
"2746","28/10/2010",4728,4767,4727,4753,140,97,10,247,25
"2747","29/10/2010",4757,4761,4726,4733,-145,153,-30,-22,-24
"2748","01/11/2010",4737,4776,4736,4771,-121,-271,247,-145,34
"2749","02/11/2010",4769,4777,4752,4773,-36,49,98,111,4
"2750","03/11/2010",4777,4804,4775,4794,147,-81,110,176,17
"2751","04/11/2010",4789,4826,4788,4818,165,208,248,621,29
"2752","05/11/2010",4840,4886,4839,4873,172,307,92,571,33
"2753","08/11/2010",4874,4885,4852,4855,-156,-108,-172,-436,-19
"2754","09/11/2010",4849,4852,4812,4821,106,-213,-46,-153,-28
"2755","10/11/2010",4821,4831,4767,4780,201,17,68,286,-41
"2756","11/11/2010",4785,4820,4784,4810,-113,60,88,35,25
"2757","12/11/2010",4810,4816,4768,4779,-204,32,-304,-476,-31
"2758","15/11/2010",4780,4797,4767,4773,-221,117,28,-76,-7
"2759","16/11/2010",4781,4793,4755,4783,-68,-44,52,-60,2
"2760","17/11/2010",4762,4762,4703,4705,74,-147,39,-34,-57
"2761","18/11/2010",4706,4726,4695,4723,10,-53,-190,-233,17
"2762","19/11/2010",4732,4758,4704,4718,-87,178,-14,77,-14
"2763","22/11/2010",4726,4759,4726,4732,-45,-40,-126,-211,6
"2764","23/11/2010",4728,4728,4675,4677,34,-141,75,-32,-51
"2765","24/11/2010",4670,4673,4638,4673,63,-69,11,5,3
"2766","25/11/2010",4683,4695,4673,4683,45,-274,-166,-395,0
"2767","26/11/2010",4688,4707,4686,4690,196,81,-129,148,2
"2768","29/11/2010",4687,4710,4649,4707,200,47,130,377,20
"2769","30/11/2010",4705,4705,4676,4676,78,59,-59,78,-29
"2770","01/12/2010",4674,4678,4649,4677,-46,-51,155,58,3
"2771","02/12/2010",4693,4771,4693,4762,-92,-168,155,-105,69
"2772","03/12/2010",4773,4801,4770,4780,-113,-80,131,-62,7
"2773","06/12/2010",4782,4794,4778,4779,119,-141,79,57,-3
"2774","07/12/2010",4782,4826,4782,4816,188,39,143,370,34
"2775","08/12/2010",4816,4816,4788,4792,59,-5,-201,-147,-24
"2776","09/12/2010",4794,4833,4794,4828,634,105,193,932,34
"2777","10/12/2010",4826,4835,4819,4830,-744,7,58,-679,4
"2778","13/12/2010",4834,4859,4833,4841,-260,108,22,-130,7
"2779","14/12/2010",4844,4857,4842,4851,24,-2,73,95,7
"2780","15/12/2010",4851,4865,4843,4853,100,157,200,457,2
"2781","16/12/2010",4851,4869,4840,4869,193,30,119,342,18
"2782","17/12/2010",4868,4868,4853,4853,327,208,247,782,-15
"2783","20/12/2010",4854,4869,4829,4829,443,-185,-11,247,-25
"2784","21/12/2010",4834,4872,4834,4862,116,-107,163,172,28
"2785","22/12/2010",4866,4877,4860,4870,-136,170,-88,-54,4
"2786","23/12/2010",4871,4899,4870,4888,203,-167,93,129,17
"2787","24/12/2010",4882,4887,4859,4868,239,207,-49,397,-14
"2788","29/12/2010",4861,4877,4851,4872,-154,146,136,128,11
"2789","30/12/2010",4874,4895,4873,4887,144,-130,136,150,13
"2790","31/12/2010",4884,4885,4847,4847,-124,38,10,-76,-37
"2791","04/01/2011",4858,4876,4836,4850,-8,60,-11,41,-8
"2792","05/01/2011",4846,4854,4811,4821,149,-181,16,-16,-25
"2793","06/01/2011",4823,4836,4804,4831,-51,332,136,417,8
"2794","07/01/2011",4824,4825,4799,4812,58,-10,81,129,-12
"2795","10/01/2011",4810,4821,4795,4819,10,380,39,429,9
"2796","11/01/2011",4816,4818,4799,4815,244,44,-80,208,-1
"2797","12/01/2011",4822,4832,4816,4832,-84,19,92,27,10
"2798","13/01/2011",4843,4902,4843,4902,-63,-43,13,-93,59
"2799","14/01/2011",4896,4909,4891,4909,214,62,35,311,13
"2800","17/01/2011",4910,4914,4865,4873,-260,-171,-70,-501,-37
"2801","18/01/2011",4872,4917,4871,4912,374,-4,7,377,40
"2802","19/01/2011",4914,4948,4901,4944,121,-18,67,170,30
"2803","20/01/2011",4933,4934,4889,4892,-839,-98,-8,-945,-41
"2804","21/01/2011",4886,4901,4847,4861,420,-312,-173,-65,-25
"2805","24/01/2011",4861,4893,4857,4888,140,15,-36,119,27
"2806","25/01/2011",4891,4925,4891,4909,-8,234,-521,-295,18
"2807","27/01/2011",4913,4916,4899,4907,-269,124,-204,-349,-6
"2808","28/01/2011",4905,4905,4855,4872,34,151,-263,-78,-33
"2809","31/01/2011",4858,4858,4816,4850,-255,-159,-96,-510,-8
"2810","01/02/2011",4854,4864,4850,4852,249,28,88,365,-2
"2811","02/02/2011",4867,4908,4867,4898,125,45,88,258,31
"2812","03/02/2011",4903,4922,4892,4919,-15,-60,-258,-333,16
"2813","04/02/2011",4924,4966,4924,4959,12,46,82,140,35
"2814","07/02/2011",4957,4966,4956,4964,-472,-271,-200,-943,7
"2815","08/02/2011",4971,4986,4969,4983,106,102,2,210,12
"2816","09/02/2011",4992,5021,4991,4995,-626,-100,-127,-853,3
"2817","10/02/2011",4993,5003,4992,5002,-596,-18,-120,-734,9
"2818","11/02/2011",4997,4997,4971,4971,-678,-111,-180,-969,-26
"2819","14/02/2011",4980,5025,4976,5023,484,-178,54,360,43
"2820","15/02/2011",5024,5027,5008,5019,-279,30,-12,-261,-5
"2821","16/02/2011",5013,5027,5008,5019,591,80,204,875,6
"2822","17/02/2011",5022,5032,5021,5026,47,273,106,426,4
"2823","18/02/2011",5018,5028,5015,5026,200,56,-14,242,8
"2824","21/02/2011",5015,5016,4974,4991,237,-23,85,299,-24
"2825","22/02/2011",5003,5006,4945,4947,-29,-230,89,-170,-56
"2826","23/02/2011",4940,4943,4921,4936,84,-17,37,104,-4
"2827","24/02/2011",4930,4930,4897,4901,45,-21,-72,-48,-29
"2828","25/02/2011",4896,4933,4890,4925,-54,34,154,134,29
"2829","28/02/2011",4928,4930,4908,4924,70,149,14,233,-4
"2830","01/03/2011",4931,4948,4920,4920,-10,265,68,323,-11
"2831","02/03/2011",4913,4913,4877,4898,221,180,148,549,-15
"2832","03/03/2011",4901,4909,4888,4903,-17,-60,-190,-267,2
"2833","04/03/2011",4916,4959,4916,4959,235,39,25,299,43
"2834","07/03/2011",4947,4948,4892,4896,-103,-8,-92,-203,-51
"2835","08/03/2011",4894,4908,4871,4902,-32,-92,-181,-305,8
"2836","09/03/2011",4902,4904,4855,4863,46,244,-238,52,-39
"2837","10/03/2011",4858,4867,4790,4791,41,16,-129,-72,-67
"2838","11/03/2011",4779,4779,4721,4735,-42,-210,-70,-322,-44
"2839","14/03/2011",4725,4725,4651,4710,5,-22,-21,-38,-15
"2840","15/03/2011",4708,4709,4564,4610,125,-223,-129,-227,-98
"2841","16/03/2011",4612,4664,4609,4644,32,85,32,149,32
"2842","17/03/2011",4633,4643,4559,4638,-58,42,-42,-58,5
"2843","18/03/2011",4653,4722,4652,4716,17,-156,20,-119,63
"2844","21/03/2011",4715,4734,4699,4734,-321,-123,122,-322,19
"2845","22/03/2011",4740,4770,4732,4738,-203,40,-57,-220,-2
"2846","23/03/2011",4736,4760,4733,4746,11,309,-214,106,10
"2847","24/03/2011",4754,4794,4754,4794,-37,104,89,156,40
"2848","25/03/2011",4800,4859,4800,4840,55,-142,-10,-97,40
"2849","28/03/2011",4833,4841,4822,4832,-1,-1,50,48,-1
"2850","29/03/2011",4829,4852,4818,4851,31,97,77,205,22
"2851","30/03/2011",4858,4928,4858,4913,115,36,77,228,55
"2852","31/03/2011",4919,4936,4904,4929,-14,-31,10,-35,10
"2853","01/04/2011",4928,4970,4928,4955,13,-12,50,51,27
"2854","04/04/2011",4961,4998,4961,4985,96,44,50,190,24
"2855","05/04/2011",4990,5004,4990,4999,-162,33,33,-96,9
"2856","06/04/2011",4998,5012,4989,5011,231,18,33,282,13
"2857","07/04/2011",5013,5023,4998,5006,18,13,-2,29,-7
"2858","08/04/2011",5002,5037,5001,5036,142,114,23,279,34
"2859","11/04/2011",5039,5070,5037,5065,-600,-37,5,-632,26
"2860","12/04/2011",5056,5059,4983,4990,-423,-175,-62,-660,-66
"2861","13/04/2011",4980,5006,4964,5000,-374,-311,-128,-813,20
"2862","14/04/2011",4988,4989,4949,4972,308,-181,-8,119,-16
"2863","15/04/2011",4970,4976,4939,4939,75,61,43,179,-31
"2864","18/04/2011",4940,4966,4928,4945,-157,368,104,315,5
"2865","19/04/2011",4930,4930,4869,4874,50,299,13,362,-56
"2866","20/04/2011",4882,4940,4882,4940,-110,-85,116,-79,58
"2867","21/04/2011",4952,4996,4950,4996,224,54,136,414,44
"2868","27/04/2011",5001,5012,4951,4954,-86,-98,-377,-561,-47
"2869","28/04/2011",4959,4991,4951,4952,63,301,127,491,-7
"2870","29/04/2011",4954,4954,4873,4899,-68,-268,59,-277,-55
"2871","02/05/2011",4901,4910,4838,4896,78,280,-102,256,-5
"2872","03/05/2011",4884,4884,4840,4855,-23,-58,29,-52,-29
"2873","04/05/2011",4850,4850,4805,4814,82,-7,-36,39,-36
"2874","05/05/2011",4810,4831,4790,4829,-25,-211,63,-173,19
"2875","06/05/2011",4811,4833,4787,4816,-33,-289,93,-229,5
"2876","09/05/2011",4825,4868,4825,4832,141,5,93,239,7
"2877","10/05/2011",4836,4858,4804,4804,-238,84,-34,-188,-32
"2878","11/05/2011",4816,4861,4816,4858,-32,-115,-33,-180,42
"2879","12/05/2011",4836,4836,4777,4777,64,-53,-7,4,-59
"2880","13/05/2011",4779,4792,4755,4787,-194,-115,-114,-423,8
"2881","16/05/2011",4770,4771,4718,4724,-142,-21,-238,-401,-46
"2882","17/05/2011",4731,4754,4721,4753,56,267,154,477,22
"2883","18/05/2011",4750,4775,4747,4765,157,-12,-99,46,15
"2884","19/05/2011",4776,4834,4776,4828,19,-88,-173,-242,52
"2885","20/05/2011",4818,4818,4803,4808,19,37,139,195,-10
"2886","23/05/2011",4798,4798,4723,4723,91,146,125,362,-75
"2887","24/05/2011",4718,4720,4676,4708,-52,-94,12,-134,-10
"2888","25/05/2011",4712,4713,4661,4662,-46,-237,-95,-378,-50
"2889","26/05/2011",4676,4735,4676,4735,250,-25,133,358,59
"2890","27/05/2011",4735,4764,4727,4760,-270,244,31,5,25
"2891","30/05/2011",4761,4761,4740,4746,356,99,47,502,-15
"2892","31/05/2011",4750,4796,4750,4789,-251,37,110,-104,39
"2893","01/06/2011",4792,4804,4776,4789,-38,-78,-240,-356,-3
"2894","02/06/2011",4769,4770,4675,4683,-13,-107,-269,-389,-86
"2895","03/06/2011",4685,4696,4662,4667,3,-170,-23,-190,-18
"2896","06/06/2011",4662,4662,4636,4649,-168,67,-23,-124,-13
"2897","07/06/2011",4641,4649,4610,4641,33,-7,84,110,0
"2898","08/06/2011",4646,4649,4592,4609,13,-69,-111,-167,-37
"2899","09/06/2011",4607,4629,4593,4622,461,-211,141,391,15
"2900","10/06/2011",4629,4660,4625,4635,-33,-237,93,-177,6
"2901","14/06/2011",4624,4657,4582,4651,-82,-136,-23,-241,27
"2902","15/06/2011",4651,4657,4625,4635,-47,-171,-25,-243,-16
"2903","16/06/2011",4618,4619,4547,4547,-20,-94,-25,-139,-71
"2904","17/06/2011",4553,4590,4533,4551,186,10,-181,15,-2
"2905","20/06/2011",4553,4584,4512,4512,-75,-290,-93,-458,-41
"2906","21/06/2011",4525,4566,4524,4565,250,-88,133,295,40
"2907","22/06/2011",4579,4622,4579,4591,62,113,184,359,12
"2908","23/06/2011",4586,4599,4560,4561,-190,218,210,238,-25
"2909","24/06/2011",4563,4577,4549,4565,200,-90,180,290,2
"2910","27/06/2011",4559,4560,4508,4514,-83,-173,-148,-404,-45
"2911","28/06/2011",4527,4554,4513,4523,-264,-36,34,-266,-4
"2912","29/06/2011",4538,4582,4538,4580,161,-95,209,275,42
"2913","30/06/2011",4586,4661,4586,4660,-57,71,-9,5,74
"2914","01/07/2011",4664,4676,4634,4648,-48,22,-83,-109,-16
"2915","04/07/2011",4659,4696,4659,4670,222,-66,145,301,11
"2916","05/07/2011",4677,4686,4652,4657,-656,1,16,-639,-20
"2917","06/07/2011",4660,4671,4641,4664,525,129,17,671,4
"2918","07/07/2011",4661,4677,4646,4666,255,11,17,283,5
"2919","08/07/2011",4675,4718,4675,4716,195,182,83,460,41
"2920","11/07/2011",4704,4704,4645,4647,-601,67,7,-527,-57
"2921","12/07/2011",4636,4636,4560,4564,-234,-70,-176,-480,-72
"2922","13/07/2011",4567,4596,4556,4583,-70,-98,152,-16,16
"2923","14/07/2011",4584,4584,4538,4561,124,20,-146,-2,-23
"2924","15/07/2011",4547,4555,4525,4543,-90,-6,112,16,-4
"2925","18/07/2011",4542,4545,4520,4540,85,224,154,463,-2
"2926","19/07/2011",4530,4551,4515,4539,141,209,-93,257,9
"2927","20/07/2011",4556,4618,4555,4618,-84,53,110,79,62
"2928","21/07/2011",4620,4645,4620,4626,-86,-219,308,3,6
"2929","22/07/2011",4635,4681,4635,4674,120,46,187,353,39
"2930","25/07/2011",4667,4668,4603,4604,-63,-226,29,-260,-63
"2931","26/07/2011",4609,4654,4609,4646,179,-163,319,335,37
"2932","27/07/2011",4639,4643,4612,4613,23,430,38,491,-26
"2933","28/07/2011",4595,4595,4539,4539,-68,42,-235,-261,-56
"2934","29/07/2011",4542,4544,4497,4500,-207,-131,-34,-372,-42
"2935","01/08/2011",4515,4590,4514,4573,12,-12,47,47,58
"2936","02/08/2011",4556,4557,4507,4510,-1,458,-48,409,-46
"2937","03/08/2011",4484,4484,4404,4408,-56,5,17,-34,-76
"2938","04/08/2011",4413,4433,4352,4353,-64,-439,-69,-572,-60
"2939","05/08/2011",4302,4302,4151,4170,-132,-149,-132,-413,-132
"2940","08/08/2011",4144,4152,4053,4057,-87,-206,-87,-380,-87
"2941","09/08/2011",4022,4103,3829,4097,75,75,75,225,75
"2942","10/08/2011",4133,4228,4133,4207,74,74,74,222,74
"2943","11/08/2011",4176,4229,4124,4204,85,-156,-58,-129,28
"2944","12/08/2011",4218,4280,4218,4238,-42,6,146,110,20
"2945","15/08/2011",4257,4347,4255,4347,119,235,-97,257,90
"2946","16/08/2011",4349,4365,4309,4317,13,37,-201,-151,-32
"2947","17/08/2011",4320,4390,4318,4372,288,14,35,337,52
"2948","18/08/2011",4370,4374,4314,4319,-14,-17,-51,-82,-51
"2949","19/08/2011",4282,4283,4170,4172,-218,-76,-149,-443,-110
"2950","22/08/2011",4170,4229,4145,4151,-194,-29,-230,-453,-19
"2951","23/08/2011",4154,4240,4154,4240,186,143,49,378,86
"2952","24/08/2011",4252,4305,4230,4236,-125,133,-159,-151,-16
"2953","25/08/2011",4248,4299,4248,4280,13,-26,83,70,32
"2954","26/08/2011",4275,4297,4267,4271,86,252,268,606,-4
"2955","29/08/2011",4280,4353,4280,4334,89,44,96,229,54
"2956","30/08/2011",4344,4378,4336,4341,264,-152,-46,66,-3
"2957","31/08/2011",4342,4370,4328,4370,188,132,58,378,28
"2958","01/09/2011",4372,4425,4372,4383,-48,3,11,-34,11
"2959","02/09/2011",4371,4371,4306,4322,97,-151,-215,-269,-49
"2960","05/09/2011",4302,4303,4218,4224,372,379,88,839,-78
"2961","06/09/2011",4207,4207,4157,4161,-70,184,-46,68,-46
"2962","07/09/2011",4180,4263,4180,4263,140,142,83,365,83
"2963","08/09/2011",4275,4298,4244,4270,-82,55,89,62,-5
"2964","09/09/2011",4268,4311,4264,4277,-99,-58,-69,-226,9
"2965","12/09/2011",4254,4255,4125,4125,-27,-46,-44,-117,-129
"2966","13/09/2011",4138,4179,4136,4158,76,-216,73,-67,20
"2967","14/09/2011",4162,4193,4083,4090,10,-346,37,-299,-72
"2968","15/09/2011",4113,4182,4110,4153,50,462,9,521,40
"2969","16/09/2011",4166,4237,4166,4230,84,116,169,369,64
"2970","19/09/2011",4221,4223,4155,4164,-97,64,-133,-166,-57
"2971","20/09/2011",4160,4164,4113,4125,29,-107,-84,-162,-35
"2972","21/09/2011",4133,4155,4111,4154,51,21,138,210,21
"2973","22/09/2011",4129,4129,4034,4045,-61,-168,-136,-365,-84
"2974","23/09/2011",4026,4037,3957,3978,-29,-210,-92,-331,-48
"2975","26/09/2011",3991,4026,3926,3928,90,-22,-129,-61,-63
"2976","27/09/2011",3952,4064,3950,4064,112,-59,112,165,112
"2977","28/09/2011",4071,4112,4069,4098,83,260,135,478,27
"2978","29/09/2011",4081,4083,4024,4068,39,6,102,147,-13
"2979","30/09/2011",4074,4094,4044,4070,-125,-128,154,-99,-4
"2980","03/10/2011",4054,4054,3958,3961,-114,38,-93,-169,-93
"2981","04/10/2011",3955,3965,3905,3936,138,-19,-26,93,-19
"2982","05/10/2011",3958,4014,3955,3992,50,150,22,222,34
"2983","06/10/2011",4008,4132,4008,4132,-20,19,-228,-229,124
"2984","07/10/2011",4144,4242,4144,4225,81,70,-91,60,81
"2985","10/10/2011",4220,4277,4211,4262,42,134,-9,167,42
"2986","11/10/2011",4276,4307,4268,4289,-26,26,26,26,13
"2987","12/10/2011",4277,4277,4231,4266,-39,-11,-11,-61,-11
"2988","13/10/2011",4278,4317,4270,4306,-41,28,56,43,28
"2989","14/10/2011",4295,4295,4260,4269,97,12,12,121,-26
"2990","17/10/2011",4284,4348,4283,4338,15,77,103,195,54
"2991","18/10/2011",4319,4319,4249,4250,-321,-66,-66,-453,-69
"2992","19/10/2011",4258,4294,4256,4275,301,315,273,889,17
"2993","20/10/2011",4264,4264,4199,4207,90,-192,197,95,-57
"2994","21/10/2011",4208,4228,4194,4203,104,-92,250,262,-5
"2995","24/10/2011",4216,4322,4216,4314,-197,90,250,143,98
"2996","25/10/2011",4326,4326,4273,4288,-20,95,139,214,-38
"2997","26/10/2011",4274,4314,4235,4301,22,14,175,211,27
"2998","27/10/2011",4305,4408,4301,4404,279,276,270,825,99
"2999","28/10/2011",4421,4472,4399,4411,185,-31,-31,123,-10
"3000","31/10/2011",4408,4417,4360,4360,181,-124,-83,-26,-48
"3001","01/11/2011",4343,4343,4297,4297,606,-65,92,633,-46
"3002","02/11/2011",4282,4283,4209,4251,57,-193,-127,-263,-31
"3003","03/11/2011",4258,4278,4213,4238,20,208,-66,162,-20
"3004","04/11/2011",4264,4343,4264,4342,-156,183,82,109,78
"3005","07/11/2011",4343,4348,4316,4335,-50,96,-31,15,-8
"3006","08/11/2011",4343,4362,4337,4357,155,-26,-70,59,14
"3007","09/11/2011",4372,4424,4372,4406,279,221,7,507,34
"3008","10/11/2011",4370,4370,4270,4307,-63,7,-123,-179,-63
"3009","11/11/2011",4308,4359,4308,4359,-48,-159,-94,-301,51
"3010","14/11/2011",4371,4424,4369,4369,12,-66,128,74,-2
"3011","15/11/2011",4365,4366,4342,4352,66,224,37,327,-13
"3012","16/11/2011",4356,4372,4314,4314,11,-219,-31,-239,-42
"3013","17/11/2011",4312,4341,4293,4324,32,42,31,105,12
"3014","18/11/2011",4306,4307,4242,4247,-50,-3,-119,-172,-59
"3015","21/11/2011",4242,4251,4212,4234,12,-23,-8,-19,-8
"3016","22/11/2011",4219,4221,4166,4204,-22,-88,-65,-175,-15
"3017","23/11/2011",4197,4198,4126,4126,-116,-121,-116,-353,-71
"3018","24/11/2011",4124,4142,4102,4115,-78,-569,-69,-716,-9
"3019","25/11/2011",4114,4114,4047,4058,-75,-216,55,-236,-56
"3020","28/11/2011",4069,4138,4069,4126,57,-42,57,72,57
"3021","29/11/2011",4132,4167,4109,4167,35,-188,2,-151,35
"3022","30/11/2011",4164,4185,4146,4185,-45,99,-15,39,21
"3023","01/12/2011",4219,4300,4219,4288,59,-11,95,143,69
"3024","02/12/2011",4285,4346,4285,4346,25,61,124,210,61
"3025","05/12/2011",4351,4391,4351,4380,29,7,28,64,29
"3026","06/12/2011",4376,4376,4316,4322,-54,-105,-54,-213,-54
"3027","07/12/2011",4331,4374,4331,4351,108,15,124,247,20
"3028","08/12/2011",4348,4350,4331,4339,81,66,122,269,-9
"3029","09/12/2011",4320,4320,4248,4264,-56,-43,-85,-184,-56
"3030","12/12/2011",4282,4332,4281,4311,48,61,60,169,29
"3031","13/12/2011",4296,4296,4241,4252,-103,-91,78,-116,-44
"3032","14/12/2011",4244,4260,4228,4250,34,-39,25,20,6
"3033","15/12/2011",4240,4240,4175,4198,-4,-93,-13,-110,-42
"3034","16/12/2011",4200,4224,4199,4219,-35,19,19,3,19
"3035","19/12/2011",4208,4208,4114,4114,-145,39,-107,-213,-94
"3036","20/12/2011",4114,4128,4103,4107,15,-105,-7,-97,-7
"3037","21/12/2011",4126,4198,4126,4190,-69,-9,64,-14,64
"3038","22/12/2011",4184,4185,4136,4142,20,-63,-56,-99,-42
"3039","23/12/2011",4154,4192,4154,4192,51,90,-137,4,38
"3040","28/12/2011",4191,4194,4140,4142,-141,-312,83,-370,-49
"3041","29/12/2011",4135,4135,4092,4123,44,192,93,329,-12
"3042","30/12/2011",4128,4141,4110,4111,-114,-65,-97,-276,-17
"3043","03/01/2012",4123,4161,4123,4155,-158,-27,55,-130,32
"3044","04/01/2012",4176,4254,4176,4240,43,59,-34,68,64
"3045","05/01/2012",4232,4232,4187,4197,-218,-82,-201,-501,-35
"3046","06/01/2012",4194,4198,4164,4164,320,-159,-65,96,-30
"3047","09/01/2012",4171,4184,4145,4162,156,-162,71,65,-9
"3048","10/01/2012",4169,4209,4169,4207,-273,276,95,98,38
"3049","11/01/2012",4214,4255,4214,4243,373,222,38,633,29
"3050","12/01/2012",4246,4252,4226,4238,-123,-2,23,-102,-8
"3051","13/01/2012",4247,4262,4245,4255,49,157,2,208,8
"3052","16/01/2012",4244,4245,4202,4209,153,-43,193,303,-35
"3053","17/01/2012",4220,4278,4219,4278,-323,149,93,-81,58
"3054","18/01/2012",4279,4290,4263,4281,121,376,250,747,2
"3055","19/01/2012",4290,4321,4279,4279,153,110,108,371,-11
"3056","20/01/2012",4285,4313,4285,4303,510,-81,-108,321,18
"3057","23/01/2012",4300,4302,4288,4288,52,311,31,394,-12
"3058","24/01/2012",4291,4311,4282,4286,364,-102,14,276,-5
"3059","25/01/2012",4290,4330,4289,4329,-32,337,56,361,39
"3060","27/01/2012",4334,4373,4334,4348,210,306,66,582,14
"3061","30/01/2012",4347,4355,4327,4334,106,50,26,182,-13
"3062","31/01/2012",4333,4349,4324,4326,33,-72,-196,-235,-7
"3063","01/02/2012",4322,4328,4291,4291,-25,-167,-165,-357,-31
"3064","02/02/2012",4306,4349,4305,4333,-256,-94,97,-253,27
"3065","03/02/2012",4337,4341,4318,4320,-296,-218,-14,-528,-17
"3066","06/02/2012",4335,4378,4334,4365,-26,-89,78,-37,30
"3067","07/02/2012",4360,4380,4340,4345,121,-107,72,86,-15
"3068","08/02/2012",4340,4367,4340,4364,301,-8,43,336,24
"3069","09/02/2012",4357,4358,4320,4357,-14,122,82,190,0
"3070","10/02/2012",4355,4362,4323,4323,-113,-219,50,-282,-32
"3071","13/02/2012",4322,4363,4321,4359,48,-16,124,156,37
"3072","14/02/2012",4354,4355,4311,4319,-50,170,85,205,-35
"3073","15/02/2012",4318,4332,4300,4327,-4,70,-94,-28,9
"3074","16/02/2012",4318,4318,4246,4257,161,-176,92,77,-61
"3075","17/02/2012",4267,4289,4264,4273,-152,175,190,213,6
"3076","20/02/2012",4289,4333,4287,4333,192,-73,-126,-7,44
"3077","21/02/2012",4335,4374,4323,4368,223,-9,56,270,33
"3078","22/02/2012",4366,4384,4353,4372,193,140,-27,306,6
"3079","23/02/2012",4371,4374,4348,4368,121,-63,16,74,-3
"3080","24/02/2012",4369,4389,4366,4389,88,-108,0,-20,20
"3081","27/02/2012",4380,4385,4346,4354,279,-306,-55,-82,-26
"3082","28/02/2012",4355,4373,4346,4351,359,-60,44,343,-4
"3083","29/02/2012",4357,4406,4357,4388,127,95,-5,217,31
"3084","01/03/2012",4381,4381,4338,4346,126,-71,-59,-4,-35
"3085","02/03/2012",4354,4381,4354,4364,-132,-125,19,-238,10
"3086","05/03/2012",4360,4364,4344,4354,92,182,90,364,-6
"3087","06/03/2012",4346,4346,4293,4296,208,-308,60,-40,-50
"3088","07/03/2012",4285,4285,4234,4234,-80,-96,-137,-313,-51
"3089","08/03/2012",4242,4266,4238,4262,68,-356,49,-239,20
"3090","09/03/2012",4271,4304,4270,4300,-145,-289,55,-379,29
"3091","12/03/2012",4303,4304,4285,4288,-50,99,101,150,-15
"3092","13/03/2012",4294,4342,4294,4336,34,-141,75,-32,42
"3093","14/03/2012",4349,4383,4348,4376,13,117,-30,100,27
"3094","15/03/2012",4371,4371,4354,4367,47,14,-106,-45,-4
"3095","16/03/2012",4368,4374,4355,4365,45,-53,-45,-53,-3
"3096","19/03/2012",4371,4398,4370,4381,24,11,-1,34,10
"3097","20/03/2012",4383,4383,4355,4366,-13,-22,-106,-141,-17
"3098","21/03/2012",4357,4366,4334,4347,44,-154,38,-72,-10
"3099","22/03/2012",4345,4373,4344,4365,35,-42,56,49,20
"3100","23/03/2012",4355,4367,4329,4361,116,-91,1,26,6
"3101","26/03/2012",4360,4381,4355,4355,154,-266,50,-62,-5
"3102","27/03/2012",4365,4398,4365,4392,93,150,-90,153,27
"3103","28/03/2012",4388,4434,4385,4432,225,-23,80,282,44
"3104","29/03/2012",4428,4434,4415,4422,121,-43,193,271,-6
"3105","30/03/2012",4424,4443,4420,4420,187,224,226,637,-4
"3106","02/04/2012",4432,4461,4414,4416,-52,239,126,313,-16
"3107","03/04/2012",4423,4438,4415,4424,-198,-31,124,-105,1
"3108","04/04/2012",4416,4425,4402,4419,-101,353,249,501,3
"3109","05/04/2012",4408,4409,4370,4402,-96,-2,243,145,-6
"3110","10/04/2012",4393,4393,4357,4374,217,-305,-17,-105,-19
"3111","11/04/2012",4363,4363,4327,4327,9,217,79,305,-36
"3112","12/04/2012",4330,4362,4330,4362,-152,184,-114,-82,32
"3113","13/04/2012",4374,4411,4374,4404,213,39,-49,203,30
"3114","16/04/2012",4394,4394,4369,4382,223,-9,56,270,-12
"3115","17/04/2012",4382,4401,4367,4369,-97,40,60,3,-13
"3116","18/04/2012",4380,4427,4380,4427,-24,-79,82,-21,47
"3117","19/04/2012",4428,4454,4426,4441,13,-108,38,-57,13
"3118","20/04/2012",4438,4446,4432,4444,476,-122,-46,308,6
"3119","23/04/2012",4443,4443,4429,4430,531,7,89,627,-13
"3120","24/04/2012",4423,4447,4416,4434,288,30,-9,309,11
"3121","26/04/2012",4442,4466,4438,4445,104,-178,-9,-83,3
"3122","27/04/2012",4446,4456,4433,4433,219,-21,34,232,-13
"3123","30/04/2012",4444,4468,4443,4467,-266,-26,110,-182,23
"3124","01/05/2012",4469,4515,4469,4497,193,218,-97,314,28
"3125","02/05/2012",4503,4513,4497,4505,153,159,124,436,2
"3126","03/05/2012",4504,4510,4494,4494,279,61,256,596,-10
"3127","04/05/2012",4488,4488,4452,4459,219,-12,98,305,-29
"3128","07/05/2012",4441,4441,4359,4362,159,129,-17,271,-79
"3129","08/05/2012",4370,4387,4360,4376,-236,-22,128,-130,6
"3130","09/05/2012",4372,4373,4316,4332,-166,-116,-139,-421,-40
"3131","10/05/2012",4327,4354,4327,4354,30,27,148,205,27
"3132","11/05/2012",4354,4359,4333,4343,141,209,-93,257,-11
"3133","14/05/2012",4345,4360,4340,4352,-8,5,86,83,7
"3134","15/05/2012",4342,4342,4302,4316,-11,-2,46,33,-26
"3135","16/05/2012",4304,4304,4215,4215,-145,49,-161,-257,-89
"3136","17/05/2012",4218,4233,4187,4208,116,-123,123,116,-10
"3137","18/05/2012",4193,4193,4079,4099,-108,-87,-187,-382,-94
"3138","21/05/2012",4105,4138,4094,4124,69,66,69,204,19
"3139","22/05/2012",4134,4174,4134,4174,35,208,40,283,40
"3140","23/05/2012",4170,4170,4119,4119,-51,5,42,-4,-51
"3141","24/05/2012",4120,4140,4102,4106,-12,-35,-14,-61,-14
"3142","25/05/2012",4108,4121,4077,4081,-141,29,-51,-163,-27
"3143","28/05/2012",4081,4122,4081,4120,-2,-211,-36,-249,39
"3144","29/05/2012",4120,4169,4092,4168,195,89,122,406,48
"3145","30/05/2012",4168,4168,4127,4149,43,-59,77,61,-19
"3146","31/05/2012",4149,4149,4092,4134,310,30,72,412,-15
"3147","01/06/2012",4134,4134,4088,4117,140,-159,-127,-146,-17
"3148","04/06/2012",4117,4117,4033,4033,-265,-282,-125,-672,-84
"3149","05/06/2012",4033,4095,4033,4092,186,10,-181,15,59
"3150","06/06/2012",4092,4112,4086,4105,40,458,38,536,13
"3151","07/06/2012",4105,4166,4105,4157,64,99,38,201,52
"3152","08/06/2012",4157,4168,4103,4111,207,165,117,489,-46
"3153","12/06/2012",4111,4131,4109,4118,237,-203,-149,-115,7
"3154","13/06/2012",4118,4133,4096,4112,-203,-293,-77,-573,-6
"3155","14/06/2012",4112,4112,4074,4090,-273,192,86,5,-22
"3156","15/06/2012",4090,4110,4084,4107,-125,13,162,50,17
"3157","18/06/2012",4107,4185,4107,4184,-60,164,214,318,77
"3158","19/06/2012",4184,4184,4151,4167,-678,-27,-55,-760,-17
"3159","20/06/2012",4167,4203,4167,4177,187,-79,2,110,10
"3160","21/06/2012",4177,4180,4131,4134,81,130,2,213,-43
"3161","22/06/2012",4134,4134,4084,4094,-218,-289,-81,-588,-40
"3162","25/06/2012",4094,4094,4041,4072,-87,-3,-178,-268,-22
"3163","26/06/2012",4072,4072,4046,4056,50,-47,56,59,-16
"3164","27/06/2012",4056,4085,4055,4084,92,40,110,242,28
"3165","28/06/2012",4084,4114,4082,4086,9,14,-119,-96,2
"3166","29/06/2012",4086,4155,4074,4136,230,120,-141,209,50
"3167","02/07/2012",4136,4190,4136,4172,37,144,274,455,36
"3168","03/07/2012",4172,4180,4160,4166,-6,-330,187,-149,-6
"3169","04/07/2012",4166,4214,4166,4214,32,321,98,451,48
"3170","05/07/2012",4214,4216,4200,4210,-244,-21,-14,-279,-4
"3171","06/07/2012",4210,4210,4187,4199,19,-146,-160,-287,-11
"3172","09/07/2012",4199,4199,4154,4160,255,-57,-49,149,-39
"3173","10/07/2012",4160,4177,4130,4138,8,-274,-5,-271,-22
"3174","11/07/2012",4138,4141,4116,4135,-18,159,6,147,-3
"3175","12/07/2012",4135,4146,4101,4106,-194,23,-25,-196,-29
"3176","13/07/2012",4106,4138,4100,4118,17,-83,-13,-79,12
"3177","16/07/2012",4118,4162,4118,4143,196,18,54,268,25
"3178","17/07/2012",4143,4188,4141,4175,-104,-11,19,-96,32
"3179","18/07/2012",4175,4177,4154,4156,11,28,-5,34,-19
"3180","19/07/2012",4156,4236,4156,4236,-45,149,131,235,80
"3181","20/07/2012",4236,4246,4217,4231,-839,47,-175,-967,-5
"3182","23/07/2012",4231,4231,4159,4159,106,63,2,171,-72
"3183","24/07/2012",4159,4169,4143,4161,150,-240,-40,-130,2
"3184","25/07/2012",4161,4161,4114,4151,-256,-301,-40,-597,-10
"3185","26/07/2012",4151,4176,4150,4174,48,-181,102,-31,23
"3186","27/07/2012",4174,4234,4174,4234,-26,-177,81,-122,60
"3187","30/07/2012",4234,4277,4234,4267,20,26,116,162,33
"3188","31/07/2012",4267,4306,4267,4289,-678,139,10,-529,22
"3189","01/08/2012",4289,4289,4274,4283,-718,-44,-46,-808,-6
"3190","02/08/2012",4283,4301,4277,4290,199,36,49,284,7
"3191","03/08/2012",4290,4290,4235,4243,-279,-167,105,-341,-47
"3192","06/08/2012",4243,4308,4243,4293,359,315,243,917,50
"3193","07/08/2012",4293,4314,4293,4311,100,269,57,426,18
"3194","08/08/2012",4311,4343,4311,4333,52,48,112,212,22
"3195","09/08/2012",4333,4350,4330,4330,128,-66,47,109,-3
"3196","10/08/2012",4330,4336,4303,4303,187,59,72,318,-27
"3197","13/08/2012",4303,4339,4303,4310,210,-282,-231,-303,7
"3198","14/08/2012",4310,4326,4300,4317,8,-147,87,-52,7
"3199","15/08/2012",4317,4336,4294,4307,-309,-132,22,-419,-10
"3200","16/08/2012",4307,4354,4307,4354,53,-112,74,15,47
"3201","17/08/2012",4354,4394,4353,4394,165,208,248,621,40
"3202","20/08/2012",4394,4401,4373,4392,-456,62,-18,-412,-2
"3203","21/08/2012",4392,4429,4388,4411,674,48,135,857,19
"3204","22/08/2012",4411,4412,4394,4403,-279,-205,-134,-618,-8
"3205","23/08/2012",4403,4430,4400,4412,545,426,151,1122,9
"3206","24/08/2012",4412,4412,4368,4376,374,409,187,970,-36
"3207","27/08/2012",4379,4403,4370,4373,-379,-210,-71,-660,-6
"3208","28/08/2012",4374,4392,4369,4387,150,129,-17,262,13
"3209","29/08/2012",4387,4387,4373,4382,-58,46,-204,-216,-5
"3210","30/08/2012",4382,4382,4328,4340,-86,-101,-3,-190,-42
"3211","31/08/2012",4340,4351,4328,4339,107,140,68,315,-1
"3212","03/09/2012",4334,4359,4313,4352,122,256,101,479,18
"3213","04/09/2012",4352,4357,4317,4326,74,7,67,148,-26
"3214","05/09/2012",4326,4326,4282,4298,10,17,-78,-51,-28
"3215","06/09/2012",4298,4343,4298,4332,205,-94,202,313,34
"3216","07/09/2012",4332,4377,4332,4349,33,310,-159,184,17
"3217","10/09/2012",4349,4365,4343,4358,72,62,118,252,9
"3218","11/09/2012",4358,4358,4341,4348,-15,25,127,137,-10
"3219","12/09/2012",4348,4385,4348,4383,-19,-159,77,-101,35
"3220","13/09/2012",4383,4383,4359,4360,-15,-95,-157,-267,-23
"3221","14/09/2012",4373,4417,4373,4410,-135,129,100,94,37
"3222","17/09/2012",4423,4430,4411,4422,-76,-18,4,-90,-1
"3223","18/09/2012",4422,4427,4406,4418,24,-22,4,6,-4
"3224","19/09/2012",4418,4443,4410,4440,555,32,89,676,22
"3225","20/09/2012",4436,4436,4417,4420,153,101,56,310,-16
"3226","21/09/2012",4420,4441,4419,4431,372,2,102,476,11
"3227","24/09/2012",4431,4431,4399,4409,104,192,101,397,-22
"3228","25/09/2012",4409,4409,4390,4396,-8,126,67,185,-13
"3229","26/09/2012",4387,4388,4373,4382,48,-61,61,48,-5
"3230","27/09/2012",4379,4403,4358,4403,-194,-10,201,-3,24
"3231","28/09/2012",4402,4413,4389,4406,211,9,19,239,4
"3232","01/10/2012",4406,4429,4395,4408,27,-54,-52,-79,2
"3233","02/10/2012",4413,4456,4413,4452,-173,-106,128,-151,39
"3234","03/10/2012",4452,4473,4451,4459,242,-7,175,410,7
"3235","04/10/2012",4459,4476,4457,4473,183,95,47,325,14
"3236","05/10/2012",4473,4515,4473,4514,531,426,139,1096,41
"3237","08/10/2012",4514,4516,4497,4502,-600,-37,5,-632,-12
"3238","09/10/2012",4503,4533,4503,4527,425,-119,26,332,24
"3239","10/10/2012",4520,4521,4498,4512,-632,-27,-146,-805,-8
"3240","11/10/2012",4512,4513,4483,4505,591,-33,-76,482,-7
"3241","12/10/2012",4505,4518,4505,4510,113,-21,88,180,5
"3242","15/10/2012",4510,4515,4501,4506,-174,215,333,374,-4
"3243","16/10/2012",4506,4538,4506,4514,-167,195,81,109,8
"3244","17/10/2012",4514,4559,4514,4551,178,-25,134,287,37
"3245","18/10/2012",4586,4602,4568,4581,193,30,119,342,-5
"3246","19/10/2012",4581,4594,4562,4594,121,137,-34,224,13
"3247","22/10/2012",4582,4583,4546,4565,-66,233,163,330,-17
"3248","23/10/2012",4563,4589,4562,4568,372,-16,-57,299,5
"3249","24/10/2012",4568,4568,4526,4531,31,240,-94,177,-37
"3250","25/10/2012",4530,4541,4528,4534,-276,-225,78,-423,4
"3251","26/10/2012",4536,4548,4495,4496,-84,-225,146,-163,-40
"3252","29/10/2012",4499,4523,4499,4499,107,280,13,400,0
"3253","30/10/2012",4500,4519,4493,4506,22,236,76,334,6
"3254","31/10/2012",4512,4543,4512,4535,189,81,136,406,23
"3255","01/11/2012",4535,4535,4480,4480,-271,-312,-208,-791,-55
"3256","02/11/2012",4491,4508,4480,4483,168,299,19,486,-8
"3257","05/11/2012",4481,4497,4459,4494,-33,116,62,145,13
"3258","06/11/2012",4492,4508,4490,4504,-46,38,-159,-167,12
"3259","07/11/2012",4504,4536,4502,4534,3,59,71,133,30
"3260","08/11/2012",4534,4534,4478,4502,-44,300,-89,167,-32
"3261","09/11/2012",4502,4502,4458,4482,-190,-293,95,-388,-20
"3262","12/11/2012",4479,4486,4465,4470,169,-66,-136,-33,-9
"3263","13/11/2012",4468,4469,4404,4404,19,-3,-11,5,-64
"3264","14/11/2012",4404,4416,4395,4411,-22,316,20,314,7
"3265","15/11/2012",4411,4411,4360,4371,-32,-187,7,-212,-40
"3266","16/11/2012",4372,4372,4356,4360,66,4,-90,-20,-12
"3267","19/11/2012",4367,4385,4362,4383,250,-88,133,295,16
"3268","20/11/2012",4383,4412,4383,4408,-56,-45,-80,-181,25
"3269","21/11/2012",4409,4409,4388,4391,13,74,50,137,-18
"3270","22/11/2012",4397,4446,4395,4432,160,-66,173,267,35
"3271","23/11/2012",4432,4432,4417,4432,174,138,64,376,0
"3272","26/11/2012",4432,4445,4432,4444,10,41,-42,9,12
"3273","27/11/2012",4444,4478,4442,4473,-136,104,15,-17,29
"3274","28/11/2012",4470,4470,4449,4463,-113,-82,94,-101,-7
"3275","29/11/2012",4462,4490,4461,4490,111,-29,22,104,28
"3276","30/11/2012",4490,4525,4490,4518,-13,-2,-45,-60,28
"3277","03/12/2012",4518,4546,4518,4540,288,-24,-89,175,22
"3278","04/12/2012",4540,4544,4510,4512,-744,-44,-44,-832,-28
"3279","05/12/2012",4512,4532,4509,4528,115,251,76,442,16
"3280","06/12/2012",4528,4535,4512,4516,68,185,71,324,-12
"3281","07/12/2012",4522,4558,4522,4556,-174,-23,23,-174,34
"3282","10/12/2012",4556,4576,4556,4562,374,46,195,615,6
"3283","11/12/2012",4562,4585,4562,4581,507,208,247,962,19
"3284","12/12/2012",4581,4609,4581,4592,210,306,66,582,11
"3285","13/12/2012",4592,4600,4586,4593,374,47,-85,336,1
"3286","14/12/2012",4593,4608,4590,4595,121,-107,72,86,2
"3287","17/12/2012",4595,4599,4583,4588,242,-236,-49,-43,-7
"3288","18/12/2012",4593,4624,4593,4610,315,104,128,547,17
"3289","19/12/2012",4619,4642,4618,4633,273,-3,164,434,14
"3290","20/12/2012",4635,4655,4625,4647,476,392,73,941,12
"3291","21/12/2012",4647,4669,4624,4635,531,-263,151,419,-12
"3292","24/12/2012",4637,4655,4637,4646,393,-40,146,499,9
"3293","27/12/2012",4646,4666,4642,4661,47,-152,-150,-255,15
"3294","28/12/2012",4665,4701,4665,4685,186,-97,28,117,20
"3295","31/12/2012",4680,4680,4660,4665,172,388,125,685,-15
"3296","02/01/2013",4665,4726,4665,4723,372,-21,156,507,58
"3297","03/01/2013",4723,4764,4723,4761,-632,49,-24,-607,38
"3298","04/01/2013",4761,4761,4737,4743,-299,-106,-94,-499,-18
"3299","07/01/2013",4746,4770,4736,4738,210,-80,-132,-2,-8
"3300","08/01/2013",4742,4756,4712,4712,-28,-180,39,-169,-30
"3301","09/01/2013",4713,4732,4713,4730,11,-125,127,13,17
"3302","10/01/2013",4730,4750,4723,4745,-220,34,18,-168,15
"3303","11/01/2013",4746,4757,4728,4734,-80,-21,124,23,-12
"3304","14/01/2013",4734,4755,4734,4746,72,-48,-107,-83,12
"3305","15/01/2013",4747,4757,4733,4743,36,-267,22,-209,-4
"3306","16/01/2013",4742,4765,4741,4765,-111,-118,67,-162,23
"3307","17/01/2013",4765,4809,4765,4780,237,199,155,591,15
"3308","18/01/2013",4780,4806,4780,4795,312,-164,-29,119,15
"3309","21/01/2013",4797,4804,4788,4802,507,430,178,1115,5
"3310","22/01/2013",4802,4826,4793,4803,584,362,180,1126,1
"3311","23/01/2013",4812,4825,4811,4812,264,-18,15,261,0
"3312","24/01/2013",4808,4838,4805,4834,193,-7,73,259,26
"3313","25/01/2013",4834,4859,4834,4859,279,430,174,883,25
"3314","29/01/2013",4866,4917,4865,4911,-260,-99,-101,-460,45
"3315","30/01/2013",4911,4929,4908,4919,31,109,121,261,8
"3316","31/01/2013",4919,4928,4888,4901,-368,21,-63,-410,-18
"3317","01/02/2013",4901,4944,4901,4942,606,137,193,936,41
"3318","04/02/2013",4942,4971,4929,4929,-600,28,-53,-625,-13
"3319","05/02/2013",4919,4919,4892,4903,736,110,165,1011,-16
"3320","06/02/2013",4903,4950,4903,4940,-37,181,10,154,37
"3321","07/02/2013",4935,4958,4928,4956,105,353,-59,399,21
"3322","08/02/2013",4953,4989,4949,4989,584,362,180,1126,36
"3323","11/02/2013",4989,4997,4980,4980,-66,-218,-135,-419,-9
"3324","12/02/2013",4980,5002,4980,4982,187,59,72,318,2
"3325","13/02/2013",4982,5033,4982,5024,-95,-3,-10,-108,42
"3326","14/02/2013",5024,5065,5021,5057,-456,9,-28,-475,33
"3327","15/02/2013",5053,5063,5043,5055,-634,-90,-225,-949,2
"3328","18/02/2013",5061,5091,5052,5083,106,-111,-143,-148,22
"3329","19/02/2013",5083,5101,5066,5101,-601,-77,-213,-891,18
"3330","20/02/2013",5101,5123,5101,5114,-600,-80,-216,-896,13
"3331","21/02/2013",5084,5094,4999,4999,-762,-32,-190,-984,-85
"3332","22/02/2013",4999,5070,4995,5037,74,63,86,223,38
"3333","25/02/2013",5036,5082,5036,5073,173,-312,-91,-230,37
"3334","26/02/2013",5056,5057,4998,5022,-136,-167,114,-189,-34
"3335","27/02/2013",5029,5060,5029,5053,-59,-63,-158,-280,24
"3336","28/02/2013",5053,5128,5053,5120,-1,199,-3,195,67
"3337","01/03/2013",5120,5120,5080,5101,210,445,197,852,-19
"3338","04/03/2013",5101,5101,5028,5028,393,18,-7,404,-73
"3339","05/03/2013",5028,5108,5028,5088,40,314,43,397,60
"3340","06/03/2013",5088,5143,5088,5131,-174,34,-7,-147,43
"3341","07/03/2013",5134,5148,5102,5123,-279,-39,-75,-393,-11
"3342","08/03/2013",5123,5144,5117,5138,586,353,227,1166,15
"3343","11/03/2013",5135,5162,5130,5160,476,-260,180,396,25
"3344","12/03/2013",5163,5174,5129,5129,-66,-94,-93,-253,-34
"3345","13/03/2013",5131,5133,5093,5104,443,38,201,682,-27
"3346","14/03/2013",5102,5114,5044,5044,102,-39,-221,-158,-58
"3347","15/03/2013",5044,5129,5044,5129,104,15,-14,105,85
"3348","18/03/2013",5113,5113,5027,5027,-243,338,-373,-278,-86
"3349","19/03/2013",5035,5070,5004,5004,49,-115,-299,-365,-31
"3350","20/03/2013",5004,5004,4956,4983,-117,26,-190,-281,-21
"3351","21/03/2013",4983,5012,4964,4977,-15,-374,13,-376,-6
"3352","22/03/2013",4974,4995,4944,4981,-9,-88,157,60,7
"3353","25/03/2013",4982,5033,4982,5002,-145,-262,55,-352,20
"3354","26/03/2013",4993,4993,4957,4965,-45,-117,6,-156,-28
"3355","27/03/2013",4973,5007,4971,5007,-63,-73,-230,-366,34
"3356","28/03/2013",5007,5007,4980,4980,14,-73,-95,-154,-27
"3357","02/04/2013",4980,5017,4979,4996,19,47,-181,-115,16
"3358","03/04/2013",4999,5020,4946,4966,-209,-6,-88,-303,-33
"3359","04/04/2013",4959,4959,4908,4919,169,-79,-228,-138,-40
"3360","05/04/2013",4925,4930,4892,4899,-31,-83,-60,-174,-26
"3361","08/04/2013",4899,4921,4897,4913,25,-7,-17,1,14
"3362","09/04/2013",4913,4980,4913,4980,51,92,114,257,67
"3363","10/04/2013",4990,4995,4963,4974,144,4,42,190,-16
"3364","11/04/2013",4974,5018,4974,5010,310,30,72,412,36
"3365","12/04/2013",5010,5024,5009,5016,50,-63,51,38,6
"3366","15/04/2013",5009,5009,4933,4967,-155,20,-1,-136,-42
"3367","16/04/2013",4967,4967,4909,4944,64,120,-63,121,-23
"3368","17/04/2013",4944,4997,4944,4994,-111,59,146,94,50
"3369","18/04/2013",4979,4980,4911,4911,389,38,27,454,-68
"3370","19/04/2013",4911,4946,4909,4923,-94,12,22,-60,12
"3371","22/04/2013",4923,4955,4923,4955,24,87,10,121,32
"3372","23/04/2013",4955,5024,4955,5003,162,100,-57,205,48
"3373","24/04/2013",5009,5085,5009,5084,209,269,125,603,75
"3374","26/04/2013",5095,5117,5082,5083,37,-3,128,162,-12
"3375","29/04/2013",5083,5112,5083,5108,98,-38,31,91,25
"3376","30/04/2013",5108,5171,5108,5169,184,-1,14,197,61
"3377","01/05/2013",5165,5167,5140,5144,39,-22,-22,-5,-21
"3378","02/05/2013",5144,5144,5094,5104,26,4,17,47,-40
"3379","03/05/2013",5104,5154,5102,5105,199,52,-63,188,1
"3380","06/05/2013",5121,5175,5120,5134,-188,-7,334,139,13
"3381","07/05/2013",5140,5143,5098,5123,-14,353,247,586,-17
"3382","08/05/2013",5131,5180,5130,5178,-70,124,40,94,47
"3383","09/05/2013",5173,5192,5165,5181,100,261,117,478,8
"3384","10/05/2013",5182,5224,5182,5191,630,-94,177,713,9
"3385","13/05/2013",5189,5204,5177,5195,584,143,230,957,6
"3386","14/05/2013",5195,5209,5192,5202,121,224,267,612,7
"3387","15/05/2013",5204,5230,5151,5173,507,326,28,861,-31
"3388","16/05/2013",5173,5192,5137,5144,-267,80,75,-112,-29
"3389","17/05/2013",5153,5173,5147,5160,108,68,41,217,7
"3390","20/05/2013",5165,5222,5165,5185,-372,-204,100,-476,20
"3391","21/05/2013",5184,5184,5138,5156,-238,-147,-44,-429,-28
"3392","22/05/2013",5163,5179,5132,5142,74,67,41,182,-21
"3393","23/05/2013",5137,5137,5037,5041,-172,44,-187,-315,-96
"3394","24/05/2013",5041,5060,4936,4964,-70,-157,-101,-328,-77
"3395","27/05/2013",4964,4964,4910,4939,32,-127,-40,-135,-25
"3396","28/05/2013",4938,4959,4930,4951,-2,-127,13,-116,13
"3397","29/05/2013",4951,4975,4943,4959,-119,-297,-111,-527,8
"3398","30/05/2013",4959,4959,4885,4917,-162,-52,-42,-256,-42
"3399","31/05/2013",4927,4946,4910,4914,-173,-87,-87,-347,-13
"3400","03/06/2013",4914,4915,4874,4874,-49,-537,-69,-655,-40
"3401","04/06/2013",4874,4892,4852,4887,-41,-329,-102,-472,13
"3402","05/06/2013",4887,4887,4821,4825,-33,-289,93,-229,-62
"3403","06/06/2013",4822,4822,4768,4772,-141,-411,-98,-650,-50
"3404","07/06/2013",4772,4774,4724,4729,-192,304,149,261,-43
"3405","11/06/2013",4729,4750,4729,4749,63,-223,93,-67,20
"3406","12/06/2013",4749,4749,4703,4716,60,-137,121,44,-33
"3407","13/06/2013",4716,4716,4650,4685,65,-157,-42,-134,-31
"3408","14/06/2013",4685,4777,4685,4776,-212,-105,86,-231,91
"3409","17/06/2013",4758,4805,4726,4805,13,324,154,491,47
"3410","18/06/2013",4805,4805,4750,4795,74,76,91,241,-10
"3411","19/06/2013",4795,4842,4795,4842,364,-95,-79,190,47
"3412","20/06/2013",4842,4842,4715,4744,119,15,-98,36,-98
"3413","21/06/2013",4744,4744,4668,4724,-125,-82,7,-200,-20
"3414","24/06/2013",4724,4724,4646,4651,-174,-95,-152,-421,-73
"3415","25/06/2013",4651,4664,4611,4634,461,-211,141,391,-17
"3416","26/06/2013",4634,4724,4634,4708,-39,-537,-31,-607,74
"3417","27/06/2013",4708,4803,4708,4785,-211,249,-104,-66,77
"3418","28/06/2013",4785,4804,4768,4775,452,134,13,599,-10
"3419","01/07/2013",4775,4775,4682,4690,378,11,77,466,-85
"3420","02/07/2013",4690,4810,4690,4810,-488,235,-74,-327,120
"3421","03/07/2013",4810,4810,4704,4728,-81,-85,-115,-281,-82
"3422","04/07/2013",4728,4783,4728,4781,-60,120,56,116,53
"3423","05/07/2013",4781,4837,4781,4826,14,59,113,186,45
"3424","08/07/2013",4826,4838,4774,4798,-64,-76,-18,-158,-28
"3425","09/07/2013",4798,4878,4798,4866,52,-71,188,169,68
"3426","10/07/2013",4866,4932,4866,4885,-502,16,12,-474,19
"3427","11/07/2013",4886,4947,4886,4947,-368,82,82,-204,61
"3428","12/07/2013",4947,4994,4947,4958,-321,-69,-69,-459,11
"3429","15/07/2013",4958,4979,4945,4966,-131,44,20,-67,8
"3430","16/07/2013",4966,4984,4958,4969,249,99,18,366,3
"3431","17/07/2013",4969,4978,4960,4966,36,-7,-49,-20,-3
"3432","18/07/2013",4966,4993,4966,4977,106,74,-9,171,11
"3433","19/07/2013",4977,4993,4948,4959,128,374,178,680,-18
"3434","22/07/2013",4960,5012,4960,4989,364,14,-37,341,29
"3435","23/07/2013",4989,5015,4989,5005,186,-97,28,117,16
"3436","24/07/2013",5005,5040,5005,5022,121,59,-36,144,17
"3437","25/07/2013",5022,5022,4994,5018,507,326,28,861,-4
"3438","26/07/2013",5018,5043,5010,5024,219,-23,-63,133,6
"3439","29/07/2013",5024,5040,5018,5028,229,150,235,614,4
"3440","30/07/2013",5028,5035,5007,5026,227,-19,66,274,-2
"3441","31/07/2013",5026,5077,5026,5036,421,181,-65,537,10
"3442","01/08/2013",5036,5076,5018,5047,96,122,93,311,11
"3443","02/08/2013",5047,5100,5047,5099,227,-19,66,274,52
"3444","05/08/2013",5099,5099,5083,5094,-690,-213,-273,-1176,-5
"3445","06/08/2013",5094,5100,5071,5088,543,445,7,995,-6
"3446","07/08/2013",5088,5088,4993,4997,-167,-7,-196,-370,-91
"3447","08/08/2013",4997,5065,4997,5047,-73,261,-77,111,50
"3448","09/08/2013",5047,5058,5008,5039,-122,-305,196,-231,-8
"3449","12/08/2013",5039,5094,5034,5094,79,-225,44,-102,55
"3450","13/08/2013",5094,5145,5094,5142,84,208,111,403,48
"3451","14/08/2013",5142,5152,5127,5141,-632,114,-7,-525,-1
"3452","15/08/2013",5141,5148,5126,5137,425,50,106,581,-4
"3453","16/08/2013",5137,5137,5088,5100,-154,-190,32,-312,-37
"3454","19/08/2013",5100,5116,5087,5102,8,-147,87,-52,2
"3455","20/08/2013",5102,5102,5050,5069,-309,-198,-75,-582,-33
"3456","21/08/2013",5069,5096,5062,5090,67,-172,37,-68,21
"3457","22/08/2013",5090,5090,5021,5067,249,-132,-16,101,-23
"3458","23/08/2013",5069,5133,5069,5115,28,-9,4,23,46
"3459","26/08/2013",5115,5148,5115,5127,-55,-74,-13,-142,12
"3460","27/08/2013",5127,5132,5102,5131,37,105,33,175,4
"3461","28/08/2013",5131,5131,5067,5078,-137,-23,-8,-168,-53
"3462","29/08/2013",5078,5089,5056,5083,-32,-60,7,-85,5
"3463","30/08/2013",5083,5125,5067,5125,60,90,19,169,42
"3464","02/09/2013",5125,5181,5118,5178,-89,-36,0,-125,53
"3465","03/09/2013",5178,5198,5178,5189,-626,24,15,-587,11
"3466","04/09/2013",5189,5189,5147,5156,-561,-151,-211,-923,-33
"3467","05/09/2013",5156,5167,5114,5138,393,-40,146,499,-18
"3468","06/09/2013",5138,5154,5114,5144,94,-243,57,-92,6
"3469","09/09/2013",5144,5180,5144,5179,41,-282,64,-177,35
"3470","10/09/2013",5179,5210,5179,5199,-3,222,122,341,20
"3471","11/09/2013",5199,5231,5199,5231,374,204,72,650,32
"3472","12/09/2013",5231,5248,5226,5238,-456,101,130,-225,7
"3473","13/09/2013",5238,5238,5206,5215,214,-43,193,364,-23
"3474","16/09/2013",5215,5260,5215,5242,389,216,124,729,27
"3475","17/09/2013",5242,5256,5223,5245,482,378,32,892,3
"3476","18/09/2013",5245,5247,5221,5230,507,89,-76,520,-15
"3477","19/09/2013",5230,5292,5230,5289,472,180,-92,560,59
"3478","20/09/2013",5289,5289,5263,5271,-302,26,-11,-287,-18
"3479","23/09/2013",5271,5271,5221,5246,102,170,334,606,-25
"3480","24/09/2013",5246,5246,5213,5230,47,-118,117,46,-16
"3481","25/09/2013",5230,5278,5227,5270,-256,301,44,89,40
"3482","26/09/2013",5270,5288,5245,5288,-243,38,-11,-216,18
"3483","27/09/2013",5288,5308,5288,5302,-36,-176,122,-90,14
"3484","30/09/2013",5302,5302,5218,5218,186,-73,17,130,-84
"3485","01/10/2013",5218,5240,5201,5206,74,-3,41,112,-12
"3486","02/10/2013",5206,5229,5206,5215,68,90,-11,147,9
"3487","03/10/2013",5215,5256,5212,5232,-5,373,32,400,17
"3488","04/10/2013",5232,5232,5196,5206,-8,7,17,16,-26
"3489","07/10/2013",5206,5213,5148,5161,-175,108,-45,-112,-45
"3490","08/10/2013",5161,5165,5125,5148,169,-48,-55,66,-13
"3491","09/10/2013",5144,5155,5118,5152,-8,175,100,267,8
"3492","10/10/2013",5152,5152,5127,5146,-50,-228,0,-278,-6
"3493","11/10/2013",5146,5237,5146,5229,168,-92,190,266,83
"3494","14/10/2013",5229,5229,5187,5206,12,-23,-143,-154,-23
"3495","15/10/2013",5206,5264,5206,5259,249,25,100,374,53
"3496","16/10/2013",5259,5270,5232,5264,2,146,14,162,5
"3497","17/10/2013",5264,5295,5264,5282,16,58,14,88,18
"3498","18/10/2013",5282,5325,5282,5321,77,-126,81,32,39
"3499","21/10/2013",5321,5365,5321,5352,49,45,31,125,31
"3500","22/10/2013",5352,5379,5352,5371,157,-124,19,52,19
"3501","23/10/2013",5371,5400,5356,5357,191,67,-29,229,-14
"3502","24/10/2013",5357,5384,5355,5374,27,-38,-8,-19,17
"3503","25/10/2013",5374,5396,5374,5386,-626,-44,-1,-671,12
"3504","28/10/2013",5386,5453,5386,5437,-456,67,102,-287,51
"3505","29/10/2013",5437,5440,5405,5411,36,11,-20,27,-26
"3506","30/10/2013",5411,5438,5411,5425,516,261,26,803,14
"3507","31/10/2013",5425,5440,5396,5420,20,61,-17,64,-5
"3508","01/11/2013",5420,5420,5400,5406,-223,-12,-236,-471,-14
"3509","04/11/2013",5406,5425,5383,5384,-238,304,-167,-101,-22
"3510","05/11/2013",5384,5432,5384,5426,149,46,-124,71,42
"3511","06/11/2013",5426,5427,5402,5426,162,69,-277,-46,0
"3512","07/11/2013",5426,5426,5404,5415,36,151,-253,-66,-11
"3513","08/11/2013",5415,5415,5374,5394,-29,-311,-375,-715,-21
"3514","11/11/2013",5394,5432,5370,5381,-59,78,124,143,-13
"3515","12/11/2013",5381,5414,5381,5387,-75,4,204,133,6
"3516","13/11/2013",5387,5387,5308,5318,-46,70,-169,-145,-69
"3517","14/11/2013",5318,5372,5318,5352,-87,246,-140,19,34
"3518","15/11/2013",5352,5400,5339,5396,-29,54,115,140,44
"3519","18/11/2013",5396,5398,5354,5378,-302,5,149,-148,-18
"3520","19/11/2013",5378,5378,5341,5348,-70,21,-140,-189,-30
"3521","20/11/2013",5348,5348,5294,5305,-14,-36,184,134,-43
"3522","21/11/2013",5305,5305,5282,5284,-134,-130,7,-257,-21
"3523","22/11/2013",5284,5347,5284,5330,33,-7,84,110,46
"3524","25/11/2013",5330,5368,5330,5346,159,310,45,514,16
"3525","26/11/2013",5346,5368,5339,5351,-69,78,-7,2,5
"3526","27/11/2013",5351,5355,5325,5325,-259,-71,-125,-455,-26
"3527","28/11/2013",5325,5358,5325,5327,7,-173,-152,-318,2
"3528","29/11/2013",5327,5331,5302,5314,7,-282,-362,-637,-13
"3529","02/12/2013",5314,5326,5265,5274,-44,-52,-152,-248,-40
"3530","03/12/2013",5274,5276,5247,5250,115,16,-279,-148,-24
"3531","04/12/2013",5250,5272,5223,5268,-52,-115,-29,-196,18
"3532","05/12/2013",5268,5271,5197,5197,-440,-1,-135,-576,-71
"3533","06/12/2013",5197,5197,5157,5186,461,-374,141,228,-11
"3534","09/12/2013",5186,5206,5138,5148,41,-211,-28,-198,-38
"3535","10/12/2013",5148,5187,5144,5146,-86,-541,-62,-689,-2
"3536","11/12/2013",5140,5145,5110,5110,-2,-211,-36,-249,-30
"3537","12/12/2013",5110,5119,5037,5069,0,-329,121,-208,-41
"3538","13/12/2013",5069,5102,5053,5102,4,-39,33,-2,33
"3539","16/12/2013",5102,5104,5065,5093,-50,-262,-106,-418,-9
"3540","17/12/2013",5093,5136,5089,5106,-88,116,30,58,13
"3541","18/12/2013",5106,5117,5096,5099,121,-83,254,292,-7
"3542","19/12/2013",5099,5202,5099,5202,69,15,173,257,103
"3543","20/12/2013",5202,5262,5202,5262,288,-48,215,455,60
"3544","23/12/2013",5262,5292,5258,5292,-117,18,30,-69,30
"3545","24/12/2013",5292,5328,5292,5326,88,-5,34,117,34
"3546","27/12/2013",5325,5362,5320,5324,-314,21,28,-265,-1
"3547","30/12/2013",5324,5358,5324,5358,51,92,19,162,34
"3548","31/12/2013",5358,5368,5340,5353,-141,-19,-88,-248,-5
"3549","31/03/2014",5377,5422,5377,5403,38,56,70,164,26
"3550","01/04/2014",5403,5409,5359,5395,-67,-69,-69,-205,-8
"3551","02/04/2014",5395,5415,5395,5409,112,14,-20,106,14
"3552","03/04/2014",5409,5425,5409,5416,-744,-23,-91,-858,7
"3553","04/04/2014",5416,5429,5405,5429,106,-131,121,96,13
"3554","07/04/2014",5429,5429,5396,5416,121,137,-34,224,-13
"3555","08/04/2014",5416,5418,5392,5409,421,207,247,875,-7
"3556","09/04/2014",5409,5473,5409,5460,-13,139,-72,54,51
"3557","10/04/2014",5460,5500,5460,5478,100,-255,-34,-189,18
"3558","11/04/2014",5478,5478,5419,5424,128,103,-27,204,-54
"3559","14/04/2014",5424,5424,5354,5354,-419,-186,-148,-753,-70
"3560","15/04/2014",5355,5400,5355,5380,25,252,25,302,25
"3561","16/04/2014",5380,5416,5379,5413,-5,332,20,347,33
"3562","17/04/2014",5413,5450,5413,5445,-112,-303,232,-183,32
"3563","22/04/2014",5445,5471,5443,5467,-43,34,221,212,22
"3564","23/04/2014",5467,5508,5467,5502,72,95,34,201,35
"3565","24/04/2014",5502,5522,5502,5516,-456,9,-28,-475,14
"3566","28/04/2014",5516,5529,5504,5516,-626,-100,-127,-853,0
"3567","29/04/2014",5516,5533,5451,5467,-279,-39,-75,-393,-49
"3568","30/04/2014",5467,5488,5446,5471,415,203,-48,570,4
"3569","01/05/2014",5471,5482,5422,5430,-13,-2,-66,-81,-41
"3570","02/05/2014",5430,5439,5413,5439,75,153,13,241,9
"3571","05/05/2014",5439,5465,5425,5443,-105,52,13,-40,4
"3572","06/05/2014",5439,5465,5425,5443,-194,86,-40,-148,4
"3573","07/05/2014",5463,5463,5402,5419,-253,-56,5,-304,-44
"3574","08/05/2014",5419,5463,5419,5455,130,-25,174,279,36
"3575","09/05/2014",5456,5456,5414,5442,-271,-136,-39,-446,-14
"3576","12/05/2014",5442,5460,5414,5429,40,9,10,59,-13
"3577","13/05/2014",5429,5483,5429,5475,120,56,51,227,46
"3578","14/05/2014",5476,5482,5454,5476,-102,14,-9,-97,0
"3579","15/05/2014",5476,5490,5452,5490,-52,353,-9,292,14
"3580","16/05/2014",5490,5490,5452,5459,13,-35,37,15,-31
"3581","19/05/2014",5459,5459,5390,5390,-302,-180,114,-368,-69
"3582","20/05/2014",5390,5413,5367,5401,116,-34,55,137,11
"3583","21/05/2014",5401,5403,5353,5403,-135,98,58,21,2
"3584","22/05/2014",5403,5446,5403,5458,107,-153,31,-15,55
"3585","23/05/2014",5458,5484,5458,5470,-13,-27,146,106,12
"3586","27/05/2014",5490,5506,5485,5490,83,292,107,482,0
"3587","28/05/2014",5490,5520,5490,5506,452,-102,17,367,16
"3588","29/05/2014",5506,5508,5485,5499,374,-307,-90,-23,-7
"3589","30/05/2014",5499,5504,5473,5473,115,-12,-119,-16,-26
"3590","02/06/2014",5466,5502,5464,5499,-13,-26,44,5,33
"3591","03/06/2014",5499,5506,5459,5460,-15,-11,-127,-153,-39
"3592","04/06/2014",5460,5463,5424,5427,-86,-132,83,-135,-33
"3593","05/06/2014",5426,5437,5400,5419,55,-57,-7,-9,-7
"3594","06/06/2014",5419,5452,5419,5443,27,-39,25,13,24
